FARE1	~Д~ eль ~w~'kлyБ пoлЮcнoгo pacпoлoжeнйЯ' ~Д~нa Бepeгy okeaнa.
FARE10	~Д~ eль ~w~'плЯж' ~Д~В Вaйc пoйнт.
FARE11	~Д~ eль ~w~'Бoльнй a' ~Д~нa Бepeгy okeaнa.
FARE12	~Д~ eль ~w~'Бoльнй a' ~Д~В Вaйc пoйнт.
FARE13	~Д~ eль ~w~'пoлй eйckйй yЧacтok' ~Д~нa плЯжe Вaшйнгтoн.
FARE14	~Д~ eль ~w~'пoлй eйckйй yЧacтok' ~Д~В Вaйc пoйнт.
FARE15	~Д~ eль ~w~'пй  a pecтopaн' ~Д~В Вaйc пoйнт.
FARE2	~Д~ eль ~w~'kлyБ мaлйБy' ~Д~В Вaйc пoйнт.
FARE3	~Д~ eль ~w~'мapйнa' ~Д~нa Бepeгy okeaнa.
FARE4	~Д~ eль ~w~'aммy-нa йЯ' ~Д~нa Бepeгy okeaнa.
FARE5	~Д~ eль ~w~'мaгaзйн тexнйkй' ~Д~нa плЯжe Вaшйнгтoн.
FARE6	~Д~ eль ~w~'нopc пoйнт мeгaмapkeт' ~Д~В Вaйc пoйнт.
FARE7	~Д~ eль ~w~'ЮВeлйpнЫй Дoм' ~Д~В Вaйc пoйнт.
FARE8	~Д~ eль ~w~'плЯж' ~Д~нa Бepeгy okeaнa.
FARE9	~Д~ eль ~w~'плЯж' ~Д~нa плЯжe Вaшйнгтoн.
FARES	плaтa:
IN_ROW	~1~ pЯДoм Бoнyc! $~1~
MFARE1	~Д~ eль ~w~'aммy-нa йЯ' ~Д~В  eнтpe гopoДa.
MFARE2	~Д~ eль ~w~'тepмйнaл' ~Д~В мeжДyнapoДнoм aзpoпopтy зckoБap.
TAXI1	~Д~йщй oплaтy.
TAXI3	~r~тВoй пaccaжйp yлeтeл В yжace!
TAXI4	плaтa okoнЧeнa!
TAXI5	Бoнyc зa ckopocть!!
TAXI6	ВoжДeнйe okoнЧeнo
TAXI7	~r~тВoЯ мaшйнa пoВpeжДeнa, oтДaй В peмoнт.
TAXIH1	ocтaнoВйcь y ВЫДeлeннoгo пepexoДa, пoДБepй пaccaжйpoВ й oтВeзй йx k пyнkтy нaзнaЧeнйЯ Дo тoгo, kak ВЫйДeт ВpeмЯ.
TSCORE2	$~1~
WFARE10	~Д~ eль ~w~'Бoльнй a' ~Д~В лйттл гaВaнa.
WFARE11	~Д~ eль ~w~'cтaДйoн' ~Д~В  eнтpe гopoДa.
WFARE12	~Д~ eль ~w~'пй  a pecтopaн' ~Д~В лйттл гaйтй.
WFARE13	~Д~ eль ~w~'пй  a pecтopaн' ~Д~В  eнтpe гopoДa.
WFARE14	~Д~ eль ~w~'Вepфь' ~Д~В Вaйcпopтe.
WFARE15	~Д~ eль ~w~'aптeka' ~Д~В лйттл гaйтй.
WFARE3	~Д~ eль ~w~'caншaйн aВтo' ~Д~В лйттл гaВaнa.
WFARE4	~Д~ eль ~w~'kayфмaн kзБc' ~Д~В лйттл гaйтй.
WFARE5	~Д~ eль ~w~'мaгaзйн тexнйkй' ~Д~В лйттл гaВaнa.
WFARE6	~Д~ eль ~w~'xayлйн пйтc Бaйkc тopгoВЫй  eнтp ' ~Д~В  eнтpe гopoДa.
WFARE7	~Д~ eль ~w~'пoлй eйckйй yЧacтok' ~Д~В лйттл гaВaнa.
WFARE8	~Д~ eль ~w~'пoлй eйckйй yЧacтok' ~Д~В  eнтpe гopoДa.
WFARE9	~Д~ eль ~w~'Бoльнй a' ~Д~В  eнтpe гopoДa.
