HELP38	ecли yБьeшь koгo-ниБyДь c opyжиeм, тo oн eгo ВЫpoнит.
HELP39	мoжeшь пoльзoВaтьcЯ paзpЫВнЫми пaтpoнaми, нo coxpaнЯи Диcтaн иЮ.
LAW4_1	paзoиДитecь. пpaВлeниe oБcyДит и peшит Вce тpeниЯ ДoлжнЫм oБpaзoм!
LAW4_13	~Д~нaЧнитe Дpaky xoтЯ БЫ c 4 paБoЧими, ЧтoБЫ нaЧaть Вoccтaниe.
LAW4_14	~Д~paзмecтитe мaшинЫ В koмплekce!
LAW4_2	paзoиДитecь. иДитe пo Дoмaм!
LAW4_3	paзoиДитecь! зтoгo нe мoжeт БЫть!
LAW4_4	paзoиДитecь. ВЫ Вce okaжeтecь нa yли ax.
LAW4_5	opyжиe k БoЮ! пopa пokoлoтить им Чepeпa!
LAW4_A	aВepи, тyт и гoВopить нeЧeгo... тoмми! тoмми! ecть пoДВижkи? нeт, нeт, нeт - пoтoм pacckaжeшь.
LAW4_B	тoмми, зтo aВepи keppингтoн - пoмнишь, мЫ ВcтpeЧaлиcь нa ВeЧepинke?
LAW4_C	нe лиЧнo.
LAW4_D	kak тЫ.
LAW4_E	y aВepи ecть пpeДлoжeниe.
LAW4_F	y нac Чтo, Дpyгиx Дeл нeт?
LAW4_G	Я пЫтaЮcь Дepжaть ВoлkoВ пoДaльшe oт ДВepeи, пoзтoмy, пoжaлyиcтa, cлyшaи мeнЯ?
LAW4_H	Я нaтЯнyт, kak лecka, и ecли пoмpy В koн e нeДeли, Я БЫ xoтeл БЫть yВepeннЫм, Чтo нe yмpy нищим.
LAW4_I	a тeпepь ycпokoитecь, oБa.
LAW4_J	cЫнok, пoмoги мнe, и Вce пoДoнkи, koтopЫe тeБe мeшaЮт жить, БyДyт cпaть ВeЧнo, oБeщaЮ.
LAW4_K	ok. Чтo Я мoгy ДлЯ тeБЯ cДeлaть?
LAW4_L	y зтoи koмпaнии Бaзa нa oЧeнь Дopoгoи зeмлe. oни нe пpoДaЮтcЯ.
LAW4_M	oни ДepжaтcЯ, kak cтapaЯ пycтЫннaЯ kpЫca, тak Чтo пpиДeтcЯ пpoниkнyть тyДa и ВЫkypить ee.
LAW4_N	иДи и paзВopoши ocинoe гнeзДo
LAW4_O	- oxpaнa БyДeт cyeтитьcЯ и мoжнo cпokoинo пpoниkнyть тyДa и Вcex пepeБить.
LAW4_P	a тЫ мoжeшь зaexaть k paфaзлЮ пepeoДeтьcЯ. зтo зaимeт нekoтopoe ВpeмЯ, нo cДeлaи зтo.
LAW4_Q	Дoлжнo БЫть, Бyнт.
LAW4_R	ecли Вce БyДeт иДти глaДko, зaeзжaитe В мoи oфиc...
