HAM1_1	~Д~koпЫ yжe пoДБиpaЮтcЯ k нaм. БЫcтpo, вЫ ДoлжнЫ иx пepeБить!
HAM1_2	~r~koпЫ ДoБpaлиcь Дo ykpЫтиЯ пepвЫми!
HAM1_3	~Д~вepнитe зти штykи нaзaД в ykpЫтиe!
HAM1_4	~Д~xopoшo! a тeпepь cлeДyЮщии!
HAM1_6	~r~yБeжищe yниЧтoжeнo, тЫ пpиДypok!
HAM1_7	~Д~koпЫ ДoБpaлиcь Дo ykpЫтиЯ! yБeитe иx, пoka oни нe yБeжaли!
HAM1_8	~Д~koпЫ ДoБpaлиcь Дo зaпacoв, ДвигaиcЯ!
HAM1_A	пpивeт? пpивeт?
HAM1_B	зaxoДи, Дopoгoи и ycпokoи мeнЯ.
HAM1_C	тЫ, Дoлжнo БЫть, тoт Бoльшoи плoxoи мyжиk, пpo koтopoгo pacckaзЫвaл пaпa.
HAM1_D	oн мнe pacckaзЫвaл пpo тeБЯ, знaeшь, koгДa пpиxoДил,
HAM1_E	и o Дpyгиx, Чтo жДyт тeБЯ.
HAM1_F	тeпepь мЫ вce yмpeм нaДoлгo, нo тЫ,
HAM1_G	тeБe Я нe oЧeнь зaвиДyЮ, xa-xa-xa-xa!
HAM1_H	Я пoлyЧил пpиkaз пpиити cЮДa.
HAM1_I	тЫ иx cлЫшишь?
HAM1_J	oни пpoизнocЯт твoe имЯ, пapeнь, виДaть oЧeнь xoтЯт c тoБoи пoзДopoвaтьcЯ?
HAM1_K	kak пoживaeт твoЯ cтapaЯ тeтyшka пoлeт, мoжeт oнa тeБe пoмoжeт.
HAM1_L	мoжeт oнa Дacт тeБe нeмнoгo жyжy, пocлe вceгo зтoгo.
HAM1_M	Дaть тeБe мaгии, ЧтoБЫ aДвokaтЫ зaтkнyлиcь, xмм?
HAM1_N	cлyшaи, зтo вce oЧeнь, ммм...Дaть мнe Чтo?
HAM1_O	Я, мнe kaжeтcЯ, Я взЯл нe тoт aДpec...
HAM1_P	cДeлaи зтo ДлЯ мeнЯ, тoмми......
HAM1_Q	kyБин Ы, гpЯзнЫe вoнЮЧиe пpoиДoxи, ммм,
HAM1_R	y мeнЯ БЫл kpacивeньkии мaльЧиk c гaити, гoлoвopeз.
HAM1_S	тeпepь oни pacckaзaли пoли ии, гДe Я xpaнЮ cвoи пopoшkи.
HAM1_T	oни ДyмaЮт, Чтo зтo нapkoтиkи, Дypakи.
HAM1_U	тeпepь БyДь xopoшим мaльЧиkoм, тoмми, Дocтaнь тeтe пoлeт пopoшok.
HAM1_V	Дa, Дa, koнeЧнo, koнeЧнo.
HAT_1A	~Д~нe ДвигaиcЯ, гaД!
