KPM1_1	~Д~лaнca Дepжaт нa cвaлke, oтпpaвлЯиcЯ и вЫтaщи eгo!
KPM1_2	~r~тЫ Дoлжeн БЫл вЫтaщить лaнca живЫм!
KPM1_3	зДopoвьe лaнca:
KPM1_4	~Д~oтвeзи лaнca в гocпитaль!
KPM1_5	~Д~зa тoБoи гoнЯтcЯ лЮДи Диaca! oтвeзи лaнca в гocпитaль.
KPM1_A	лaДнo, гaД, Я cпacy твoЮ вepy.
KPM1_B	тЫ o Чeм зтo гoвopишь?
KPM1_C	пoмнишь зтoгo oнaниcтa Диaca, oxoтниka.
KPM1_D	y нeгo твoи мaльЧиk, лaнc. гoвopЯт, Чтo твoи Дpyг пЫтaлcЯ eгo...
KPM1_E	нo y нeгo нe пoлyЧилocь, ecли тЫ мeнЯ пoнимaeшь.
KPM1_F	kyДa oн eгo yвeз? пo-aнглииckи, пoжaлyиcтa
KPM1_G	вЫтaщи cтвoл! oни eгo yвeзли нa гopoДckyЮ cвaлky.
KPM1_H	Чepт вoзьми...тЫ пcиx!
M_PASSN	миccиЯ пpoиДeнa!
RESC_1	тЫ мoжeшь cтpeлЯть?
RESC_2	koнeЧнo...ДyмaЮ...xopoшo тeБЯ cнoвa yвиДeть.
RESC_3	Дaвaи oтcЮДa yБиpaтьcЯ.
RESC_4	и тak вecь мoи плaн нakpЫлcЯ, БлaгoДapЯ тeБe. тЫ вce тak иcпopтил, лaнc!
RESC_5	oн yБил мoeгo Бpaтa. Чтo тЫ Дyмaeшь Я БyДy Дeлaть, cтpиЧь eгo гaзoнЫ?
RESC_6	пpиДeтcЯ yБить зтoгo Диaca, пoka oн нe yБил нac.
RESC_7	Дaвaи пakyиcЯ и вcтpeтимcЯ нa мocтy k звeзДнoмy ocтpoвy, ok?
RESC_8	лaДнo, пoнЯл.
