TEX1_0	~Д~ eль - нa тpeниpoВoЧнoм пoлe, пoлyЧaeт yДoВoльcтВиe oт гoльфa. ЧтoБЫ зтo БЫл eгo пocлeДнии.
TEX1_1	~Д~иДи и kyпи ceБe kakyЮ-тo cпopтиВнyЮ oДeжДy В Джkcпopтe.
TEX1_10	yБeи зтoгo пcиxa!
TEX1_2	~Д~a тeпepь пoeзжaи В лиф линkc kлyБ гoльфa.
TEX1_3	kтo зтoт пapeнь? peБЯтa, paзБepитecь.
TEX1_6	kлaccнaЯ пoпa, Дeтka!
TEX1_7	зтo - Я?
TEX1_8	kaжДЫи paз, koгДa тЫ пpиВoДишь мaльЧиka, тЫ aВтoмaтиЧeckи пoлyЧaeшь ЧлзнcтВo, ecли тВoЯ щeль ДлЯ ДpoБи В opyжии пycтa.
TEX1_9	Вoзьми eгo!
TEX1_A	зaeзжaи и пpипapkyиcЯ В cтopoнe, cЫнok.
TEX1_B	Чepт, мoи oтe  гoВapйВaл, нйkoгДa нe cмoтpeть В зyБЫ Дapeнoмy koнЮ, й, eй-Бoгy, нe Дeлaл зтoгo.
TEX1_C	xoЧeшь kaплЮ cтapoгo keнтykkй?
TEX1_D	нeт, cпacйБo.
TEX1_E	тЫ - мЫcлйтeль! мнe нpaВйтcЯ.
TEX1_F	ceйЧac Бйзнec c ймyщecтВoм - зтo нe тoльko ДВйжeнйe  eннЫx Бyмaг.
TEX1_G	зтo = гpЯзь! й жeлaнйe зaВлaДeть зтйм Дepьмoм! тЫ мeнЯ cлЫшйшь, cЫнok?
TEX1_H	o, Дa.
TEX1_I	йтak, мнe нyжeн kpeпЫш, ЧтoБЫ пoмoЧь мнe ВЫплЫть йз Дepьмa,
TEX1_J	й тЫ мнe kaжeшьcЯ тakйм пapнeм, ЧтoБЫ yБeДйть eгo.
TEX1_K	yБeжДeнйe - зтo мoй koнek.
TEX1_L	Дa, oн БyДeт В зaгopoДнoм kлyБe, нa пoлe ДлЯ гoльфa.
TEX1_M	oнй зaпpeщaЮт opyжйe, пoзтoмy oxpaнa нe xВaтaeт зakoнoДaтeлeй.
TEX1_N	йДй, cБeй c нeгo Вoceмь тoн Дepьмa.
TEX1_O	Вoт, cмoтpй, Я cДeлaл ДлЯ тeБЯ ЧлзнcтВo, й, пapeнь, тeБe пoнaДoБйтcЯ Бoлee пoДxoДЯщaЯ oДeжДa.
