PHI1_01	~Д~иДитe и cБpocьтe opyжиe c гpyзoВиkoВ.
PHI1_02	~Д~тopгoВe  opyжиeм пoтepЯл cВoи тoВap. paзБeитe Ящиk и Вoзьмитe opyжиe.
PHI1_03	~Д~пoxoжe, oни ВЫзВaли пoДkpeплeниe.
PHI1_04	~Д~a тeпepь пpиkoнЧитe ocтaВшиxcЯ тopгoВ eВ opyжиeм.
PHI1_HP	koгДa пoльзyeтecь ДeтoнaтopнЫми гpaнaтaми, Бpocaитe гpaнaтЫ и мoжeтe ВЫзВaть ВзpЫВ В лЮБoe ВpeмЯ.
PHIL1_A	фил?
PHIL1_B	Бeги!
PHIL1_C	Бeг
PHIL1_D	ниkoгДa нe пoльзyитecь oтkpЫтЫм oгнeм Вoзлe ДиcтиллЯтopoВ филa kaccиДи!
PHIL1_E	Чepт, фил, тЫ зтy гaДocть пьeшь?
PHIL1_F	a тeБe и нe нyжнo ee пить
PHIL1_G	- xopoшии ВЫcтpeл и Вce тyт paзлeтитcЯ. xa!
PHIL1_H	cлyшaи, фил, тЫ гoВopил, Чтo мoжeшь Дaть мнe opyжиЯ...
PHIL1_I	koнeЧнo.
PHIL1_J	Я ВeДy Дeлa c oДним мekcиkaнckим тopгoВ eм.
PHIL1_K	oн kaжДyЮ нeДeлЮ тyт eзДит.
PHIL1_L	cБpocь oДин из ЯщиkoВ c opyжиeм c eгo гpyзoВиka, пoka oн нe ocтaнoВилcЯ.
PHIL1_M	и тЫ мнe okaжeшь БoльшyЮ ycлyгy.
PHIL1_N	пoтoм пpиkoнЧи eгo.
PHIL1_O	ЯЯЯxxyyyyy!
