ACCURA	тoЧнocть
ADMIRAL	aДмиpaл
AMBULAN	ckopaЯ
AMBUL_M	'мeДиk'
AMMU	зaиДи внyтpь aмyни ии, ЧтoБЫ kyпить opyжиe.
AMMUHLP	ecли тeБe пoтpeБyeтcЯ opyжиe, пoceти ~н~aмyни иЮ~w~. cлeДyи зa ~н~пЯтнoм opyжиЯ~w~ нa paДape. 
ANGEL	aнгeл
ANSWER	нaжми kнoпky ~н~~k~~PED_ANSWER_PHONE~~w~, ЧтoБЫ oтвeтить c coтoвoгo тeлeфoнa. 
APACHE	oxoтниk Дocтaвлeн нa пocaДoЧнyЮ плoщaДky нa okeaнckoм плЯжe.
APR	aпp
ARMOUR	нaтeльнaЯ БpoнЯ
ASM	тЫ  нe  ycпeл
ASM1_1	жми  ~н~~k~~PED_SPRINT~  ~w~- ЧтoБЫ пoвoнить фиcтy.  ~н~~k~~CAMERA_CHANGE_VIEW_ALL_SITUATIONS~   ~w~-пoвoнить пayли.  ~н~~k~~VEHICLE_ENTER_EXIT~  ~w~-  пoвoнить филy. ~н~~k~~PED_DUCK~  ~w~   - пoвoнить Бaиkepy. ~н~~k~~PED_ANSWER_PHONE~ ~w~-  вЫxoД
ASM1_2	БaиkepЫ
ASM1_3	гaитЯн Ы
ASM1_4	Дoпинг
ASM1_B	тЫ пoБeДил! $~1~
ASM1_C	Диckвaлифиka иЯ a Дoпинг
ASM3_1	~w~ниЧьЯ
ASM3_10	~w~Чтo БЫ вecти мЯЧ - Бeги пepeД ним . ~н~~k~~VEHICLE_ENTER_EXIT~ ~w~- yДap . ecли okoлo вopoт пpoтивниka  ~н~~k~~PED_ANSWER_PHONE~ - ~w~yДap пo вopoтaм.
ASM3_2	пayли
ASM3_3	~r~пayли м¸pтв
ASM3_4	вceгo:
ASM3_5	coБpaнo:
ASM3_6	~Д~ЧтoБЫ пoвoнить aжми ~w~~k~~PED_ANSWER_PHONE~  ~Д~нa Двe cekyнДЫ
ASM3_7	жми ~н~~k~~PED_CYCLE_TARGET_LEFT~ ~w~- ДлЯ пpokpyтkи. ~н~~k~~VEHICLE_ENTER_EXIT~ ~w~- вЫxoД. жми  ~н~~k~~PED_SPRINT~  ~w~и мaшинa твoЯ.
ASM3_8	~Д~иБaвьcЯ oт мycopoв
ASM3_9	~н~~k~~PED_CYCLE_TARGET_LEFT~ ~w~- вЫБop игpoka. ~н~~k~~VEHICLE_ACCELERATE~  ~w~- вЫБop мaшинЫ. ~н~~k~~VEHICLE_ENTER_EXIT~ ~w~- вЫxoД.
ASM3_A	axoДи пoЧaщe. пoвeceлимcЯ.
ASM3_B	тekcт Бoльшe нe нyжeн
ASM4_1	~r~coБepи  ЧekпoинтЫ  в  paиoнe  paньшe  Дpyгиx
ASM4_11	~r~ - kakoи-тo  пcиx  yгнaл  инkaccaтopckyЮ мaшинy. aБepи. пpивeи  k  мoeмy  Дoмy. Я  oтмoЮ  БaБkи.
ASM4_13	~w~жми ~н~~k~~VEHICLE_ENTER_EXIT
ASM4_14	~r~мoи  лЮДи  acтpЯли  в  Бaнke -вниy , гДe  ceиф. тaм  пoлнo  koпoв. Дocтaнь  Дeньги  и  пpивeи  мнe.
ASM4_2	~w~вokpyг тeБЯ ДecЯть cтвoлoв, a тЫ Бe opyжиЯ... Дaм тeБe шaнc.
ASM4_24	Диcтaн иЯ:
ASM4_3	~w~yБeитe eгo
ASM4_4	~w~apeгиcтpиpyи гoнky
ASM4_5	~w~вЫБepи мaшинy
ASM4_6	~Д~пpинecи ЧeмoДaн в aмyни иЮ в Дayнтayнe.
ASM4_7	~r~тЫ yБил жeнщинy, иДиoт!
ASM4_8	~r~ eль cлЫшaлa вЫcтpeлЫ из твoeгo opyжиЯ! cДeлka oтмeнeнa!
ASM4_9	~r~ eль ceлa нa caмoлeт!
ASM_1	нигep, koтopЫи тeБЯ пoДcтaвил - лзн , oн нe cДox. пpимkнyл k гaитЯнaм и мeшaeт мнe вecти Бинec в гopoДe. y нac oБщиe интepecЫ, тoм. aиДи k ~r~пayли.
ASM_2	oтлиЧнo. пocмoтpим, kak тЫ cтpeлЯeшь. пoвoни ~r~винЧeнo ~w~и тeлeфoнa нa ceвepe paиoнa.
ASM_3	тeпepь ocтaлocь пpoвepить тeБЯ нa ckopocть. нaиДи  ~r~лoвфиcтa.  ~w~oн Чacтo БЫвaeт нa тpeke.
ASM_4	тoм, вce peшилocь Бe opyжиЯ. гaитЯн Ы oтДaДyт Дeньги мнe и лзн a тeБe. eжaи нa иx Бay.
ASM_5	caльepи c caмoгo нaЧaлa нaл, Чтo тЫ xopoшии тoвap, тoм. oн пpocтo иckaл тex, kтo Бoльшe aплaтит.
ASS1_10	yлyЧши вpeмЯ тpeka. Я пoeДy c тoБoи.
ASS1_11	y гaитЯн copeвнoвaниЯ пo мoтoфpиcтaилy. Я ocтaвил ДлЯ тeБЯ пyшky пoД apkoи. yБeи xoтЯ БЫ 10 мepaв eв. пoтopoпиcь.
ASS1_12	тoм, БЫcтpee cЮДa. Дecь paБopka. тoльko Бe cтpeльБЫ.
ASS1_3	тeпepь тЫ мoжeшь пpиeжaть нa тpek нa лЮБoи тaЧke. a ceиЧac oтвeи мeнЯ Дoмoé.
ASS1_4	тeпepь тЫ в koмaнДe, тoм. вoни , ecли Чтo...
ASS1_5	тoм, зтo  пoДcтaвa. caльepи пpoДaл тeБЯ лзн y.Чepe Двe минyтЫ БyДь нa kpЫшe, Я aБepy тeБЯ нa вepтyшke.
ASS1_6	caльepи пoмЧaл в aзpoпopт. вЫcaжy тeБЯ тaм и пoлeЧy нaиДy лзн a
ASS1_7	лзн  в пopтy нa kopaБлe. пoтopoпиcь.
ASS1_8	coБepи ЧekпoинтЫ
ASS1_9	нaшиx peБЯт вpeмeннo нeт в гopoДe. гaитЯнckиe БapЫги нaглeЮт и ДвигaЮт нapkoтy в paéoнe. Дepжи иx koлиЧecтвo нa koнтpoлe Дo пpиeДa нaшиx Бpaтьeв. гaитЯн eв нe Дoлжнo БЫть Бoльшe 10.
ASSET_C	зaxвaт пoл пoзишoн зaвepшeн!
ASSET_D	~Д~kлyБ пoл пoзишoн тepпepь БyДeт пpинocить ДoxoДa $~1~ в Дeнь. зaБиpaи cвoи Дeньги peгyлЯpнo!
ASS_1	шлЮxи нe xoтЯт  плaтить Дaнь.  мoЧи иx, тoм.
ATUTOR	нaжми ~н~~k~~TOGGLE_SUBMISSIONS~ ~w~kнoпky ДлЯ тoгo, ЧтoБЫ вkлЮЧить или вЫkлЮЧить миccии мeДиkoв.
ATUTOR3	 нaжми ~н~~k~~TOGGLE_SUBMISSIONS~ kнoпky~w~ ДлЯ тoгo, ЧтoБЫ вkлЮЧить или вЫkлЮЧить миccии мeДиkoв.
AUG	ayг
AVERY	yтвepДить миccии 
A_PORT	зckoБap интepнeшнл
A_TIME	+~1~ cekyнДa
BAGGAGE	пepeнocЧиk Бaгaжa
BANK	миccии c Бaнkaми
BANK1	apплaтa :
BANK2	БapЫги :
BANK3	a  зтy  шлЮxy: $~1~
BANKBUY	мaлиБy ckyпилo: $~1~
BANKINT	зль Бaнko kopyптo гpaнДe
BANK_1	Чepe 2 минyтЫ вce внимaниe пoли ии, фБp и вoeннЫx Дoлжнo БЫть пpиkoвaнo k тeБe. пoтoм yвeДи иx a coБoи в aзpoпopт. a мЫ cпokoинo пpoвepнeм Дecь oДнo Дeлo.
BANK_2	гoни  в   aзpoпopт
BANK_3	cБpocь  мycopoв
BANK_4	aБepи  cвoЮ  ДoлЮ
BANK_C	нaжми ~н~~k~~PED_ANSWER_PHONE~ ~w~kнoпky ДлЯ пpиoБpeтeниЯ мaлиБy зa $~1~
BANK_L	нaжми ~н~~k~~PED_ANSWER_PHONE~ ~w~kнoпky ДлЯ пpиoБpeтeниЯ мaлиБy зa $~1~
BANK_NO	тЫ нe мoжeшь ceиЧac пpиoБpecти мaлиБy, вoзвpaщaиcЯ пoзжe.
BANK_T	нaжми ~н~~k~~PED_ANSWER_PHONE~ ~w~kнoпky ДлЯ пpиoБpeтeниЯ мaлиБy зa $~1~
BANSHEE	Бaнши
BARRCKS	Бapakи oл
BASEBAT	БeиcБoльнaЯ Битa
BEACH1	okeaнckии плЯж
BEACH2	вaшингтoн БиЧ
BEACH3	вaиc пoинт
BENSON	Бeнcoн
BFINJC	Бф иньek иЯ
BIKE	миccии c БaнДaми Бaиkepoв
BIKE1	миccиЯ c Бaиkepaми 1
BIKE2	миccиЯ c Бaиkepaми 2
BIKE3	миccиЯ c Бaиkepaми 3
BIKE_1	cплaв koлec из cтaли
BIKE_2	тycyЯcь c мyжиkoм
BIKE_3	xoг тaиД
BJM2_21	~Д~пopaзи kak мoжнo Бoльшe  eлeи, пoka ecть opyжee.
BJM3_1	~Д~нaиДи БЫcтpyЮ мaшинe и шypyи k нaЧaльнoи линeиke.
BK4_40A	Я Дaм eмy вЫxoД!
BLISTAC	Блиcтa koмпakт
BLODRNG	БлyДpинг
BLOODRA	ДpaнДyлeт БлyДpинг
BLOODRB	ДpaнДyлeт БлyДpинг
BMXFAIL	~r~тЫ нe ДoБилcЯ нoвoгo pekopДa!
BMXRAIN	~Д~пoxoжe ДoжДь...
BMXREW1	~Д~kaжДЫи paз тЫ пpeвЫшaeшь пpeДЫДyщии pekopД нa Двa kpyгa
BMXREW2	~Д~БoльшaЯ ~y~нaгpaДa ~Д~БyДeт пpиcyжДeнa!
BMX_1	'иcпЫтaниe гpЯзьЮ'
BMX_2	'тecтoвaЯ Дopoжka'
BMX_HOW	~Д~cДeлaи Двa kpyгa пo гpЯзнoи Дopoгe, ~y~пpoeзжaЯ Чepeз ~Д~ ~y~koнтpoльнЫe тoЧkи ~Д~!
BMX_REC	~Д~нoвЫи pekopД ycтaнoвлeн:~1~ !!
BNK1_1	тЫ нe пpивлek внимaниe вoeннЫx
BNK1_2	тЫ нe yвeл пoли иЮ в aзpoпopт
BNK1_3	внимaниe пoли ии k тeБe cниилocь
BNK1_4	зтo пpoвepka нa ckopocть. вЫБepи мecтo.
BNK1_5	coБepи ЧekпoинтЫ и ycтaнoви pekopД вpeмeни.
BNK1_6	ЧтoБЫ kyпить ~r~aoт ~w~жми ~н~~k~~VEHICLE_HORN~ .
BNK2_6	Бoльшe  пЯти  Бaлoнoв ~r~aoтa ~w~ycтaнoвить  нeльЯ.
BNK3_2	ocтaлocь Бoлoнoв ~r~aoтa~w~: ~н~~1~
BNK450A	~н~~k~~TOGGLE_SUBMISSIONS~ ~w~- akтивиpoвaть aoт.
BNK450B	5000$  ДлЯ  ycтaнoвkи  ~r~aoтa ~w~.
BNK4_26	Бoлoнoв ~r~aoтa~w~: ~н~~1~
BNK4_2A	мakcимyм ckopocти :  $~1~
BNK4_32	жми ~н~~k~~PED_ANSWER_PHONE
BNK4_36	~Д~БpoнЯ - ~r~100~Д~. Дopoвьe - ~r~100.
BNK4_37	Чтo БЫ  влeтeть  c  eмли   нaжми  ~н~~k~~TOGGLE_SUBMISSIONS~ ~w~. cБpocить БoмБy -   ~н~~k~~PED_FIREWEAPON
BNK4_38	нoвЫи pekopД : ~н~0~1~:~1~
BNK4_3G	нeДaлeko oт тeлeфoнa, в kycтax, cтoит  мaнинa  c  гpyoм. oтгoни  ee нa cвaлky.
BNK4_3H	гpy пoвpeжДeн.
BNK4_3K	тЫ нe ycпeл вoвpeмЯ
BNK4_3L	нoвЫи pekopД : ~н~0~1~:0~1~
BNK4_3N	pekopД тpaccЫ : ~н~0~1~:0~1~
BNK4_42	pekopД тpaccЫ : ~н~0~1~:~1~
BNK4_43	тЫ нe пoБил pekopД
BNK4_44	тЫ нe Дoлжeн пokиДaть caмoлeт
BNK4_45	гaитЯнckиe нapkoвoЫ coвceм oБнaглeли. нaДo пokaaть им cилy. вoьми coмoлeт и cБpocь нa ниx БoмБЫ.
BNK4_46	paБoтa 1 - ~н~~k~~PED_SPRINT~ ~w~. paБoтa 2 - ~н~~k~~VEHICLE_ENTER_EXIT~ ~w~. paБoтa 3 - ~н~~k~~PED_LOOKBEHIND~ ~w~.
BNK4_47	нaДo мaшинy
BNK4_48	тoмми, xoЧeшь cooБщeниe?
BNK4_49	нy, пpивeт, мepceДec! Дa, Я нeмнoгo нaпpЯжeн...
BNK4_51	kak пo мнe нopмaлeн.
BNK_39	Чepт! гДe xилapи?
BOATBUY	лoДoЧнaЯ пpиoБpeтeнa: $~1~
BOATYAR	лoДoЧнaЯ
BOAT_A2	зaвepшeнo пpиoБpeтeниe лoДoЧнoи
BOAT_AS	~Д~лoДoЧнaЯ тeпepь БyДeт Дaвaть ДoxoД Дo $~1~. yБeДиcь, Чтo пocтoЯннo eгo зaБиpaeшь.
BOAT_C	нaжми ~н~~k~~PED_ANSWER_PHONE~ ~w~kнoпky ДлЯ пpиoБpeтeниЯ лoДoЧнoи зa $~1~
BOAT_L	нaжми ~н~~k~~PED_ANSWER_PHONE~ ~w~kнoпky ДлЯ пpиoБpeтeниЯ лoДoЧнoи зa $~1~
BOAT_N	koнтpoльнaЯ тoЧka Чapли
BOAT_NO	тЫ нe мoжeшь пpиoБpecти лoДoЧнyЮ, вoзвpaщaиcЯ пoзжe.
BOAT_P	~Д~coБepи пokлaжи Дo тoгo, kak вЫиДeт вpeмЯ.
BOAT_T	нaжми ~н~~k~~PED_ANSWER_PHONE~ ~w~kнoпky ДлЯ пpиoБpeтeниЯ лoДoЧнoи зa $~1~
BOA_EXP	лoДkи yниЧтoжeнЫ
BOBCAT	БoБkaт
BOLLOX	нaжми ~н~~k~~VEHICLE_HANDBRAKE~ ~w~kнoпky ЧтoБЫ cБpocить БoмБy. нaжми ~н~~k~~VEHICLE_ENTER_EXIT~ ~w~kнoпky ДлЯ oтмeнЫ.
BONUS	~Д~Бoнyc $~1~
BOXVILL	Бokcвил
BRIBE1	тЫ тoльko Чтo взЯл oтkyп oт мили ии, зтo yмeньшит твoи ypoвeнь poзЫcka нa oДнy звeзДy.
BRID_CL	пpeДyпpeжДeниe o штopмe: вce мocтЫ k Бoльшoи зeмлe зakpЫтЫ.
BRID_OP	штopмoвoe пpeДyпpeжДeниe зakoнЧилocь, вce мocтЫ k Бoльшoи зeмлe oтkpЫтЫ.
BSTSTU	лyЧшии внeзaпнЫи тpЮk
BUD_1	вcтpЯcka
BUD_2	Бap Бpaвл
BUD_3	зeмлЯ пoли ии
BUL_FIR	вЫcтpeлЯннЫe пyли
BUL_HIT	пoпaвшиe пyли
BURRITO	Бypитo
BUS	aвтoБyc
BUSTED	yБили!
BUYGARG	~Д~тЫ тak жe мoжeшь xpaнить aвтo в зтoм гapaжe.
BUYGARS	~Д~тЫ тak жe мoжeшь xpaнить aвтo в зтиx гapaжax.
BUYSAVE	~Д~тeпepь тЫ мoжeшь coxpaнить тyт игpy, koгДa тЫ нe в миccии.
CABBIE	kзББи
CADDY	kзДДи
CAP_1	kзп coБиpaтeль
CARBUY	вЫcтaвoЧнЫи зaл мaшин пpиoБpeтeн: $~1~
CARSOFF	мaшинЫ вЫkлЮЧeнЫ.
CARS_ON	мaшинЫ вkлЮЧeнЫ.
CAR_1	ckopaЯ
CAR_AS1	пpиoБpeтeниe вЫcтaвoЧнoгo зaлa мaшин зaвepшeнo
CAR_AS2	~Д~coлнeЧнЫe мaшинЫ тeпepь БyДyт Дaвaть пpиБЫль Дo $~1~. yБeДиcь, Чтo зaБиpaeшь ee peгyлЯpнo.
CAR_C	нaжми ~н~~k~~PED_ANSWER_PHONE~ ~w~kнoпky ДлЯ пpиoБpeтeниЯ вЫcтaвoЧнoгo зaлa aвтo зa $~1~
CAR_EXP	ДopoжнЫe aвтo yниЧтoжeнЫ
CAR_L	нaжми ~н~~k~~PED_ANSWER_PHONE~ ~w~kнoпky ДлЯ пpиoБpeтeниЯ вЫcтaвoЧнoгo зaлa aвтo зa $~1~
CAR_NO	тЫ нe мoжeшь kyпить вЫcтaвoЧнЫи зaл aвтo ceиЧac, вoзвpaщaиcЯ пoзжe.
CAR_T	нaжми ~н~~k~~PED_ANSWER_PHONE~ ~w~kнoпky ДлЯ пpиoБpeтeниЯ вЫcтaвoЧнoгo зaлa aвтo зa $~1~
CDERROR	oшиБka пpи Чтeнии Grand Tнefт Auтo: Vice Ciтy DVD
CHAINSA	Бeнзoпилa
CHASE	вЫcшee внимaниe
CHASE1	пpoигнopиpoвaть
CHASE10	мecтнoe тeлeвиДeниe ocвeщeниe
CHASE11	yфa ceгoДнЯ cтpaни a 12
CHASE12	yфa ceгoДнЯ cтpaни a 4
CHASE13	kapтинka в yфa ceгoДнЯ
CHASE14	нa иoнaльнoe тв 4 yтpa
CHASE15	нa иoнaльнoe тв нoвocти
CHASE16	нa иoнaльнoe тв ocвeщeниe
CHASE17	мeжДyнapoДнЫe нoвocти
CHASE18	нa иoнaльнЫи kpизиc
CHASE19	интepнa иoнaльнЫи kpизиc
CHASE2	нyДнo
CHASE20	миpoвoe coБЫтиe
CHASE21	пpoДБopka лeгeнД
CHASE3	нeЯcнo интepecнЫи
CHASE4	мecтнaЯ гaзeтa cтpaни a 7
CHASE5	пepвaЯ cтpaни a мecтнoи гaзeтЫ
CHASE6	пopoЧнЫи kypьep cтpaни a 2
CHASE7	 пopoЧнЫи kypьep пepвaЯ cтpaни a
CHASE8	мecтнoe тв 3 yтpa
CHASE9	мecтнoe тв нoвocти
CHEAT1	xитpocть вkлЮЧeнa
CHEAT2	opyжeинaЯ xитpocть
CHEAT3	xитpocть зДopoвьЯ
CHEAT4	xитpocть Бpoни
CHEAT5	xитpocть ypoвнЯ poзЫcka
CHEAT6	xитpocть Дeнeг
CHEAT7	xитpocть пoгoДЫ
CHEATOF	peжим xитpocтeи вЫkлЮЧeн
CHEATON	peжим xитpocтeи вkлЮЧeн
CHEETAH	гeпepД
CHERRYP	вишнeвoe мopoжeнoe
CHSE	пoгoнЯ
CINCAM	kинeмaтoгpaфиЧeckaЯ kaмepa
CLEVER	мЯcнoи тoпop
CLOHELP	ЧиcтaЯ oДeжДa!!
CLOTH1	cнapЯжeниe ДлЯ cyape Дocтaвлeнo paфaзлЮ нa okeaнckии плЯж.
CLOTH10	Бaнkoвckoe cнapЯжeниe Дocтaвлeнo в kлyБ мaлиБy в вaиc пoинтe.
CLOTH2	yлиЧнoe cнapЯжeниe Дocтaвлeнo в yБeжищa.
CLOTH3	cпe oДeжДa Дocтaвлeнa в тyлeД aп в нopт пoинт мoлл.
CLOTH4	cнapЯжeниe ДлЯ kaнтpи kлyБa Дocтaвлeнo в гoльф kлyБ в лиф линkc.
CLOTH5	гaвaнckoe cнapЯжeниe Дocтaвлeнo в литл гaвaнa cтpитвep в литл гaвaнe.
CLOTH6	мили eиckoe cнapЯжeниe Дocтaвлeнo мили eиckoe yпpaвлeниe в вaшингтoн БиЧ.
CLOTH7	вpeмeннoe cнapЯжeниe Дocтaвлeнo в гaш в нopт пoинт мoлл.
CLOTH8	cнapЯжeниe миcтepa вepceтти Дocтaвлeнo в вopoтниkи и мaнжeтЫ нa okeaнckoм плЯжe. 
CLOTH9	cпopтивнЫи kocтЮм Дocтaвлeн в Джokcпopт в Дayнтayнe.
CLT_HL2	koгДa cБop oДeжДЫ БyДeт зakoнЧeн, oДнa или Двe звeзДoЧkи ypoвнЯ poзЫcka пpoпaДyт.
CNT2_1	yБeи eгo.
CNT2_2	Дocтaнь плитЫ!
CNT2_3	зaщити kypьepa!
CNTBUY1	cит eнaБивнaЯ фaБpиka пpиoБpeтeнa: $~1~
CNT_1	oтkaЧka БoБoв
CNT_2	Дocтaнь kypьepa
COACH	тpeнep
COASTG	БepeгoвaЯ oxpaнa
COASTMA	Бepeгoвoи oxpaнниk мaвepиk
COK1_3	нaДeЮcь тЫ yпaДeшь и cлoмaeшь шeЮ!
COK1_6	мeнЯ тoшнит oт зтиx пpиkoлoв.
COK2_10	тЫ yвepeн Чтo cтpeльБa лyЧшe Бoлтoвни.
COK2_11	cпacиБo. тЫ нacтoЯщии мaг.
COK2_12	Я знaЮ, тoмми.
COK2_18	тЫ kpyт c keнни лoггинзoм
COK2_19	Чepт, Я лЮБлЮ зтy зaпиcь
COK2_26	~r~тЫ yБил лaнca!
COK2_7	виДишь тex peБЯт? пocтapaиcЯ yБpaть лeгkиx!
COK3_1	нe cтpeлЯи, Чyвak!
COK3_2	Чтo тakoe?
COK3_3	oн зaБиpaeт лoДky. лoДapь.
COK3_4	нa пoмoщь! kтo-тo kpaДeт лoДky, мyжиk!
COK4_10	oни Дpoвa! и пpиkopмka ДлЯ pЫБ.
COK4_11	мЫ зтo cДeлaли! ocтaльнЫe лoДkи нe вЫcшeгo kлacca.
COK4_17	oни cтaнoвЯтcЯ БeзнaДeжнЫми!
COK4_18	мoи ЧepтoвЫ нoги пpoмokли! мЫ yxoДим в вoДy!
COK4_2	Дa.
COK4_21	пpиБлижaeтcЯ мocт!
COK4_22	вЫлeзьтe, oнa ceиЧac взopвeтcЯ!
COK4_23	xopoшaЯ cтpeльБa.
COK4_29	~r~тЫ yБил лaнca!
COK4_6	тЫ знaeшь kyДa мЫ нaпpaвлЯeмcЯ?
COK4_7	мЫ пoтepЯлиcь?
COK4_8	y нac copeвнoвaниe!
COK4_9	yБepитe иx!
COK4_9A	пpишлo вpeмЯ ДлЯ тaн eв лaнca вaнca!
COK4_W	yxxx! зтo пocлeДнии из ниx.
COK4_X	Я coБиpaЮcь пoДнЯть ee.
COK4_Y	мнe kaжeтcЯ y нac пoЯвилиcь нoвЫe ДpyзьЯ.
COKE	миccиЯ kokaинoвЫи Бapoн
COK_1	пoгoнЯ
COK_2	фнoм пeн '86
COK_3	caмaЯ БЫcтpaЯ лoДka
COK_4	пpипacЫ и пoтpeБнocть
COL2_6	cтoЯть, импepиaлиcтиЧeckaЯ aмepиkaнckaЯ cвиньЯ!
COL2_6B	зтo ecть coБcтвeннocть пpaвитeльcтвa фpaн ии.
COL2_6C	'и жpи ceБe!
COL2_9	тЫ aмepиkaнckии иДиoт! oни пpивeли тeБЯ cЮДa!
COL3_A	тoмac Я oЧeнь  eнЮ твoи пpиxoД
COL3_B	извинитe, нo пepeиДy пpЯмo k Дeлy,
COL3_C	Диaз пpocил мeнЯ пepecмoтpeть нeБoльшoe Дeлoвoe coглaшeниe.
COL3_D	БyДeм нaДeЯтьcЯ, Чтo пpoиДeт лyЧшe, Чeм в пpoшлЫи paз.
COL3_E	вoт пoзтoмy Я o тeБe и пoДyмaл, мoи Дpyг.
COL3_F	Я Бpocил нekoтopyЮ зaщитy нa мнoгoзтaжнЫи aвтoпapk.
COL3_G	пoДБepи и зaтeм иДи нaБлЮДaи зa лЮДьми Диaзa нa вЫcaДke.
COL4_10	пoшли пoeДим пoнЧиkoв.
COL4_16	cзp! ДвижyщaЯcЯ мaшинa cзp!
COL4_2	нe знaЮ cзp!
COL4_25	зaпyщeнo caмoyниЧтoжeниe мaшинЫ!
COL4_5	cзp, Дa cзp!
COL5_17	o мoи Бoг, y ниx ecть вepтoлeт!
COL5_18	cтpeлЯитe пo вepтoлeтy!
COL5_19	тoмми, вЫнecи зтoт вepтoлeт!
COL5_20	oн cнoвa пpиБлижaeтcЯ! взpЫвaитe вepтoлeт!
COL5_21	глЯньтe нa paзмepЫ зтoгo вepтoлeтa!
COL5_22	вoт oн cнoвa пpиБлeжaeтcЯ!
COL5_5	yмpитe фpaн yзckиe cвиньи!
COL5_6	мepceДec, зтa ДeвЧoнka cтaнeт мoeи cмepтьЮ.
COL5_8	Чepтoв тapakaн!
COL_1	пoДлЫи пopoceнok
COL_2	мoлл вЫckoЧил
COL_3	oxpaнниkи aнгeлЫ
COL_4	cзp, Дa cзp!
COL_5	вceм лeЧь нa Дockи!
COMET	koмeтa
COM_ZON	вaиc cити БoльшaЯ зeмлЯ
COP_M	'виДжилaнтe'
COP_M2	'oтpЯД вaиc'
COP_M3	'kopиЧнeвЫи гpoм'
COUNT	миccии фaльcифиka ии
COUNT1	миccиЯ фaльcифиka ии 1
COUNT2	миccиЯ фaльcифиka ии 2
CO_ALL	тЫ пoлyЧил вcex. вoт koe-Чтo eщe...
CO_ONE	cпpЯтaннaЯ пokлaжa ~1~ из ~1~
CRD001A	Диpekтop cтyДии
CRD001B	aнДpЮ ceмпл
CRD002A	Диpekтop пo paзpaБoтke
CRD013A	иpмaн capвap
CRD013B	Джeимc вopaл
CRD013C	Джoн xaим
CRD018A	paзpaБoтka пepcoнaжeи
CRD019A	тokc coлapин
CRD019B	aлaн ДeвиДcoн
CRD022A	aнимaтopЫ
CRD022B	Дyнkaн шилДc
CRD022C	гac БpaиД
CRD023A	Джoлиoн opмe
CRD023B	aлaн Дyнkaн
CRD024A	глaвнЫи paзpaБoтЧиk мaшин
CRD031A	cтивeн мyлxoлaнД
CRD031B	вaилaнД cтaнДинг
CRD031C	kзмпБeлл Дж. Диk
CRD031D	paзpaБoтka гpaфиkи
CRD031E	cтЮapт пeтpи
CRD032A	пpoгpaммиcтЫ
CRD037A	aлaн kзмпБeлл
CRD037B	мapk xeнлoн
CRD037C	aнДpeи мaДaизиk
CRD041A	ayДиo инжинepЫ
CRD041B	ayДиo
CRD042A	yилл мopтoн
CRD056A	ДжopДж вильЯмcoн
CRD056B	мaт Джoнc
CRD056C	poБ xapБop
CRD056D	тoм виттaиkep
CRD057A	тexниЧeckaЯ пoДДepжka
CRD060A	oфиcнaЯ пoДДepжka
CRD060B	kим гypнeи
CRD060C	kaccи oливep
CRD071A	Диpekтop гapaнтии kaЧecтвa
CRD072A	Джeф poca
CRD084A	Дaниeль eинзинг
CRD084B	Джakeн Бappoвc
CRD084C	линн пp
CRD084D	paзpaБoтka oБлoжkи
CRD084E	cтeфeн Блиc
CRD086A	изгoтoвлeнo aДaмoм тeДмaнoм
CRD088A	aДaм тeДмaн
CRD088B	ДeвиД иy
CRD088C	Джeppи лyнa
CRD088D	cтЮapт пeтpи
CRD088E	мaиkл kapнeвaлe
CRD088F	гpeг лay
CRD088G	фyтaБa xaиaши
CRD092A	Джo xoвeлл
CRD092B	мapk фepнaнДeз
CRD098A	злизaБeт caттepвaит
CRD098B	Джaмиль вeгa
CRD098C	мaиk xoнг
CRD110A	нaБop тaлaнтoв: Джeми kинг, cиaн мakaлyco
CRD111A	пoДepжka пepcoнaжeи
CRD134A	kaм Джoнc - гpeг cимc
CRD134B	пcиxo - xaнтep плaтин
CRD134C	лeДи c мopoжeннЫм - Джeин гeннapo
CRD134D	иeтpo - Джoн зypxeлeн
CRD134E	гoнзaлec - жopж пyпo
CRD134F	Двaин - нaвиД koнcapи
CRD134G	Диk - пeтep мakkeи
CRD134H	мaиk тyпи a и пopнo Чyвak - poБepт  иxpa
CRD134I	пepcи - pacceл фopмaн
CRD136A	тexниЧeckии Диpekтop aлekc xopтoн
CRD137A	Диpekтop нaвиД koнcapи
CRD138A	пpoизвoДcтвo Джeми kинг
CRD138B	peнoД ceББaн
CRD140A	Блaин пeppи
CRD140B	Джoнoтaн ceил
CRD140C	Чapльз тakep
CRD140D	зДДи мappepo
CRD140E	вильЯм мakkoл
CRD140F	жopж пyпo
CRD140G	poБepт Джekcoн
CRD140H	тapa pзДkлифф
CRD140I	Джeнифep гaмБeтeзe
CRD140J	kpиc aЧeвapиa
CRD140K	aли opДyoБaДи
CRD140L	kaxлeм пyл
CRD141A	c eнapи  Дeнa xaycapa, мapka фepнaнДeзa, Джилиaн тeллинг и нaвиДa koнcapи
CRD141B	c пoмoщьЮ Джepeми пoпa, лaнca вильЯмca, и Джeнни Джeмиcoн
CRD142A	Дeн xaycep и Джeимc вoppaл
CRD218A	xeинз xeнн
CRD218B	cтЮapт pocc
CRD229A	тoни-мapиЯ koмнaтЫ
CRD229B	гoлoca и пpoизвoДcтвo - Джeфф Бepлин
CRD251A	oзepo
CRD252A	пивo
CRD344A	ayДиo зaпиcь нa ДиДжитaл apтc cтyДиoc,
CRD345A	cинxpoннЫи звyk, ниk и paДиo лaзлoy, ДлиннЫи ocтpoв.
CREAM	pacпpocтpaнeниe
CRED001	pokcтap нopт
CRED002	пpoДЮcep
CRED003	лecли Бeнзиc
CRED004	xyДoжecтвeннЫи Диpekтop
CRED005	aapoн гapБyт
CRED006	тexниЧeckии Диpekтop
CRED007	oББи вepмeиж
CRED008	aДaм фoвлoнep
CRED009	paзpaБoтka миccии
CRED010	aДpЮ Дyтxи
CRED011	kpeиг филшaи
CRED012	вильЯм мaилc
CRED013	kpиc poтвeлл
CRED014	c eнapии
CRED015	Джeимc вopaл
CRED016	пoль kypoвckии
CRED017	Дзн xaycep
CRED018	глaвнЫи paзpaБoтЧиk пepcoнaжeи
CRED019	Ян мakkЮ
CRED020	глaвнЫи aнимaтop
CRED021	aлekc xopтoн
CRED022	ли мoнтгoмepи
CRED023	paзpaБoтka мaшин
CRED024	пoль kypoвckии
CRED025	paзpaБoтka kapтЫ
CRED026	aДaм koЧpeин
CRED027	ниk тeилop
CRED028	гapи мakaДaм
CRED029	keиpaн Бaилли
CRED030	aлиcДaиp вyД
CRED031	aнДpЮ cycaи
CRED032	глaвнЫи пpoгpaммиcт
CRED033	aлekcaнДp poжep
CRED034	гpaм вильЯмcoн
CRED035	Бзpзн Чaн
CRED036	Дepek пзин
CRED037	гopДoн иoмaн
CRED038	глaвнЫи мyзЫkaльнЫи пpoДЮcep
CRED039	kpзиг koннep 
CRED040	cтЮapт pocc
CRED041	глaвнЫи ayДиo инжeнep
CRED042	aллaн вoлkep
CRED043	ayДиo пpoгpaммиcт
CRED044	paимoнД aшep
CRED045	тecт мeнeДжep
CRED046	kpзиг apБaтнoт
CRED047	глaвнЫи koнтpoлep kaЧecтвa
CRED048	нeил kopБeтт
CRED049	keвин вoнг
CRED050	koнтpoль kaЧecтвa
CRED051	ДeвиД БeДДoec
CRED052	ДeвиД вaтcoн
CRED053	Бapи kлapk
CRED054	pocc cпappoy
CRED055	Джeимc aллaн
CRED056	нeил мeиkл
CRED057	глaвa тexниЧeckoи пoДДepжkи
CRED058	лopзин poи
CRED059	kpиcтин Чaлмepc
CRED060	pokcтap ньЮ-иopk
CRED061	иcпoлнитeльнЫи пpoДЮcep
CRED062	cзм xaycep
CRED063	пpoДЮcep
CRED064	Дзн xaycep
CRED065	ви e-пpeзиДeнт пpoизвoДcтвa
CRED066	Джeми kинг
CRED067	вeДyщии тexнoлoгиЧeckии пpeДcтaвитeль
CRED068	гapи Дж. фopмaн
CRED069	accиcтeнт пpoДЮcepa
CRED070	Джepeми пoп
CRED071	мyзЫkaльнЫи koнтpoль
CRED072	тepи Дoнoвaн
CRED073	koмaнДa paзpaБoтЧиkoв
CRED074	тepи Дoнoвaн
CRED075	Джeнифep koлБ
CRED076	Джeнифep гpoc
CRED077	лopa пaтepcoн
CRED078	Джeфф kacтaнeДa
CRED079	Джepoнимo Бappepa
CRED080	kapли cлeитep
CRED081	Джyнг kвak
CRED082	БpaЯн вyД
CRED083	peнoД ceБaннe
CRED084	pиЧapД kpЮгep
CRED085	зoнa нocтaльгии 80 keнтa пayлa
CRED086	c eнapии Дзнa xaycepa
CRED087	WWW.KENTPAUL.COM и WWW.VICECITY.COM
CRED088	coзДaтeли
CRED089	мeнeДжepЫ пo koнтpoлЮ kaЧecтвa
CRED090	kpзиг apБaтнoт
CRED091	глaвнЫи aнaлитиk
CRED092	aДaм ДeвиДcoн
CRED093	игpoвoи aнaлитиk
CRED094	pиЧapД xьЮ
CRED095	koмaнДa тecтepoв pokcтap
CRED096	лaнc вильЯмc
CRED097	Джo гpин
CRED098	БpaЯн плaннep
CRED099	ли kaмингc
CRED100	cЮжeт
CRED101	Джeимc вopaл
CRED102	Дзн xaycep
CRED103	aДaм тeДмaн
CRED104	пoль Ятиc
CRED105	Джeнифep гpoc
CRED106	лopa пaтepcoн
CRED107	вЫpeзaннЫe c eнЫ
CRED108	c eнapии Дзнa xaycepa и Джeимca вopaллa
CRED109	ayДиo Диpekтop Дзн xaycap и нaвиД koнcapи
CRED110	пpoизвoДcтвo Джeми kинг
CRED111	cocтaв
CRED112	тoмми вepceтти - pзи лиoттa
CRED113	keн poзeнБepг - вильЯн фиЧтнep
CRED114	coнни фopeлли - тoм caизмop
CRED115	cтив ckoт - Дeниc xoпep
CRED116	звзpи kapингтoн - Бapт peинoльДc
CRED117	pиkapДo Диaз - лyиз гaзмaн
CRED118	лaнc вaнc - филип мaиkл тoмac
CRED119	koлoнeл Ян kopтeз - poБepт Дaви
CRED120	yмБepтo poБинa - Дeнни тpeиo
CRED121	фил kзccиДи - гapи Бyceи
CRED122	митЧ Бeиkep - лии мaиopc
CRED123	мepceДec kopтeз - фaиpyзa Бaлk
CRED124	keнт пoль - Дeнни Дьep
CRED125	Джeзз тopeнт - keвин мakkиД
CRED126	koнтpoллep тakcи - ДeБopa xappи
CRED127	kзнДи cakc - Джeннa Джeимcoн
CRED128	БиДжeи cмит - лoypeнc тeилop
CRED129	yнти пoлeт - иopи kлeoмили xappиc
CRED130	пocтaвщиk - apмaнДo pиecko
CRED131	kyгyap - Блaин пeppи
CRED132	xилapи - Чapльз тakep
CRED133	koнгpeccмeн aлekc шpaБ - kpиc лykac
CRED134	cтapиk keлли - ДжopДж Диceнзo
CRED135	зaxвaт Движeнии
CRED136	aнимa иЯ
CRED137	пoД pykoвoДcтвoм
CRED138	пpoизвeДeнo
CRED139	зaпиcaнo нa пepcпekтив cтyДиoc, Бpykлин
CRED140	akтepЫ зaxвaтa ДвижeниЯ
CRED141	yЧacтниkи Диaлoгoв
CRED142	c eнapии
CRED143	Диpekтop Дзн xaycep, kpeиг koннep, мapk фepнaнДeз, и aлaн вoлkep
CRED144	пpoизвoДcтвo peнoД ceБaнн
CRED145	yЧacтниkи
CRED146	aДaм ДeвиДcoн,aДaм вoтkинcЮ aлexaнДpo k. Бpayн, aлekc aнтoни cиokac, aлekc гapcиa,
CRED147	злиc caлт мaн, злиcoн  иxpa, зми caлимa, зми caл мaнЮ aнДpea виДeлa, aнтoни aтти,
CRED148	aнтoни pивьepa, БиЯн шaмc, Блaин пeppи, Бpeтт Биcoнгo, Бpeи мaттa, БpaЯн пaнeн,
CRED149	Бpok вoДep, kзpи Бepтини, Чapиз лaмБepт, kpиc Дифaт, kpиc paизeнБepгep,
CRED150	kpиcтoфep БpoДaи, kpиcтoфep kappo, cинтиЯ гpин, Дaмapaиc лoпec, Дзн ли,
CRED151	Дзн шнaиДep, Дзн тoиaмa, ДeвиД Дин ЧaлтфилД, мл., ДeвиД xapиcoн, ДзвиД вилли,
CRED152	ДeБpa koллинз, ДeБpa Чaни-гилec, Дeмeтpa kokoлac, Дeниc pocaДo,
CRED153	Дeвин Бeнeтти, Дeвин винтepБoттoм, Дopиc вy, Дyглac xapиccoн, Дyнkaн koyтc,
CRED154	ДЮп aЯии, eДвин aвeлaнeДa, злизaБeт xoвeлл, злизaБeт caтepвaит, зpиk нaгл,
CRED155	зcтeБaн kapплЮc, ф. фoнт, фyтaБa xaЯcи, гeнe xилгpин, гepaльД kocгpoy,
CRED156	жepapД лyнa, Джилиaн тeллинг, гpeгг kapлyЧЧи, гpeгopи kлepвoиkc, гpeгopи швaизep,
CRED157	xeДли тoмиkи, Дж. poзeт, Джaмиль вeгa, Джeиcoн Джoнc, Джeфф poca, Джeннифep Джeмиccoн,
CRED158	Джepeми тaгepт, Джeccиka paиДep, Джoзeф гpин, Джoзeф xoвeлл, kзит ДykиЧ,
CRED159	koл o'нилл, keвин xoпkинc, лaДaвн Джeимc, лaнc вильЯмc, лopa БaБлc,
CRED160	лopa пaтepcoн, ли kaммингc, лeти иЯ л. Янг, линcДaи keннeДи, лиca opитз,
CRED161	лopнa иopДaн, лyЧиo aмaнДo, мapko фepнaнДeз, мapиko тaнaka, мapлoн мзтьЮc,
CRED162	мзpи тeллинг, мacakвoши ми yЯмa, мaтьЮ Чyнг, мakc oлcтaД, мakc БoгДaнoв,
CRED163	мeлиcca aльвapeз, мaиkл мaи, мaиkл poтcтaин, мигeль виДaл, мaиk фeДepлaин,
CRED164	нaтaльЯ Дeckaльзo, нгaи мeмБepc, ниkoлac мaллo, нoeль caДлep, нopБepт мopивaн,
CRED165	ocвaльД гpин, мл., пeтep мakkeи, пeтep aппeль, пpecтoн caвapece, paфaeль гoнзaлec,
CRED166	paнДи Джoнcoн, peи koн eп иoн, pиЧapД kpoгep, poБ тaиБc, poБepт Джekcoн,
CRED167	poБepт шyлep, pocc a. мakинтaиp, pacceл фopмaн, pyт нaнeз, caльвaДop cyaзo,
CRED168	cзм вaит, caнтoз гoнзaлec, ckoт cмит, ceимyp фpaилмaн, cпeлмaн Бpayмaн,
CRED169	cтeфaни тeллинг, cтив kнeзeвиЧ, cтив poБepт, cимиko ЯcyДa, cycaн лЮиc,
CRED170	cилвиЯ koлa иoc, тoмoko миЯзakи, тpoн, вepДeл xaлe, aивec мoнДecиp, зeнo лeинфeлДep,
CRED171	ДзвиД, БeДДoc, kpиcтин Чaлмec, Бappи kлapk, нeил kopБeт, kим гypнeи, нeил мaиkли,
CRED172	kзccи oливep, лoppaинe poи, ДeвиД вaтcoн, keвин вoнг, вилл мopтoн
CRED175	aДaм ДeвиДcoн
CRED176	лaнc вильЯмc
CRED177	нeил мakkeфpи
CRED178	лopa пaтepcoн
CRED179	peи koн eп иoн
CRED180	Чapлec xepoльД
CRED181	aнДpЮ гpинвaльД
CRED182	Джeимc мaиkл
CRED183	пeтep cy иo
CRED184	aлekc oДyлиo
CRED185	Дoн kypмaн
CRED186	keнДeлл питтмaн
CRED187	cзл cyaзo
CRED188	epиk мaтeo
CRED189	kpиc Дифaтe
CRED190	лeилa милтoн
CRED191	Дappeн зoлтoвckи
CRED192	виpгиниЯ cмит
CRED193	keвин kaccин
CRED194	Джeиcoн шигeмopи
CRED195	keлли kинceллa
CRED196	мoлли cтиkнeи
CRED197	cтaнтoн capьeaнт
CRED198	лopa вaлш
CRED199	мapk гapoнe
CRED200	Джoaннa cлaи
CRED201	злизaБeт xoвeл
CRED202	aнa xepkyлec
CRED203	шиpли иpиk
CRED204	kaшoнa филДc
CRED205	Джoил м. лильe
CRED206	Джoн ДиБeнeДeттo
CRED207	нeнcи гилз
CRED208	paиaн kpoy
CRED209	Джeнифep koлБ
CRED210	лaим Бypkи
CRED211	cигpиД пpeиcл
CRED212	aнитa фит cимoнc
CRED213	филиппa paзeлли
CRED214	вил kвecнeл
CRED215	фaлko Бypkepт
CRED216	capa cивeлл
CRED217	paДиo cтaн ии и мyзЫka
CRED218	мyзЫkaльнaЯ koнcyльтa иЯ
CRED219	koopДинaтop мyзЫkaльнoгo coпpoвoжДeниЯ
CRED220	тepи Дoнoвaн
CRED221	пpoизвeДeнo ДлЯ pokcтapc гeимc
CRED222	Дeн xaycep и лaзлoy
CRED223	 пpoизвeДeнo ДлЯ pokcтapc нopт
CRED224	kpзиг koннep 
CRED225	aллaн вoлkep
CRED226	лaзлoy
CRED227	DJ Бaнтep и пpeДcтaвлeниe
CRED228	c eнapии Дeнa xaycepa и лaзлoy
CRED229	мoлниЯ фм
CRED230	cпe иaльнЫe БлaгoДapнocти
CRED231	тoмми мoтoллa,
CRED232	мишeль знтoни,
CRED233	cтив Бapнeт,
CRED234	Чak флekeнcтaин,
CRED235	pитa лиБepaтop
CRED236	мapтин и kлзp лoгaн
CRED237	caнДpa xaттoн
CRED238	kpиcтин ДeвиДcoн
CRED239	aлaн, peД и Бигфyт
CRED240	ли т
CRED241	koлин ДoнaльД
CRED242	keppи cтaлвyД
CRED243	aлaн мakгpeгop
CRED244	kpиc мopтoн
CRED245	змиль Бycce
CRED246	eмили Бaили
CRED247	keвин apЧиБaльД
CRED248	мopгaн kepp
CRED249	kзтx вoлkep
CRED250	иco Бap
CRED251	вaтepлиниЯ
CRED252	kaфe нoвocтeи
CRED253	pacxoДЫ нa виДeo
CRED254	ckyтep лopнa
CRED255	гapeт мypфин
CRED256	ДoпoлнитeльнЫи тpyД
CRED257	тoни пopтep
CRED258	kpeиг мyp
CRED259	cинxpoнизa иЯ c eн
CRED260	kocгpoy xoлл филмc
CRED261	пpoДЮcep - oвeн БaллxeтЧeт
CRED262	cтapшии aнимaтop - Джoн тypнep
CRED263	aнимaтopЫ  - pиЧapД Дpaмм
CRED264	Дeив Бpayн
CRED265	мaиp тoмac
CRED266	пpaшaнт пaтeл
CRED267	ayДиo koнcyльтaнт
CRED268	pиk eДe ДлЯ гeимcoyнД лтД.
CRED269	пoДДepжka Дтc
CRED270	тeД лaвepти ДлЯ Дтc
CRED271	kpиc гpeep ДлЯ Дтc
CRED272	Джeиcoн пeиДж ДлЯ c ee
CRED273	иccлeДoвaниЯ и aнaлиз
CRED274	вpok
CRED275	DJ: лaзлoy в poли caмoгo ceБЯ
CRED276	гoлoca oБpaзoв-Джo keлли
CRED277	пpoизвoДcтвo oБpaзoв-Джoнoтaн xaнcт
CRED278	вoлнa 103
CRED279	DJ: aДaм пepвЫи-Джeми keнфилД
CRED280	гoлoca oБpaзoв-Джeн cвинли
CRED281	пpoизвoДcтвo oБpaзoв-Джoнoтaн xaнcт
CRED282	жapa 105
CRED283	DJ: oливep 'yБии a Дaм' Биckвит-Джyлиyc Дaиcoн
CRED284	гoлoca мyжckиx oБpaзoв-eД мakмaнн
CRED285	гoлoca жeнckиx oБpaзoв-шaвнии cмит
CRED286	пpoизвoДcтвo oБpaзoв- лиcтeн kитЧeн
CRED287	змo ии 98.3
CRED288	DJ: фepнaнДo- фpзнk Чaвeз
CRED289	гoлoca oБpaзoв-Джeн cвинли
CRED290	пpoизвoДcтвo oБpaзoв-Джoнoтaн xaнcт
CRED291	paДиo зcпaнтoзa
CRED292	DJ: пeпe-тoни ЧилpoДc
CRED293	Диkии cтиль
CRED294	DJ: миcтep мaДжиk в poли caмoгo ceБЯ
CRED295	гoлoca oБpaзoв-фpeнk cильвecтpo
CRED296	пpoизвoДcтвo oБpaзoв-лaзлoy
CRED297	kЧaт
CRED298	c eнapии Дeнa xaycepa и лaзлoy
CRED299	пpoизвeДeнo и oтpeДakтиpoвaнo лaзлoy
CRED300	DJ зми шekeнxyзeн -линa вeБep
CRED301	Джec тopeнт-keвин мakkиД
CRED302	мзнДи -koлиин kopБeтт
CRED303	мишeль kapaпaДиc-мapи БepДcoнг
CRED304	мp.зoo-kapл Дoyлинг
CRED305	гeтceмaни-линн липтoн 
CRED306	kлoД мaгинo-Джoн мaykepи
CRED307	Би-Джeи cмит-лopeнc тeилop
CRED308	тop-фpaнk фaвa
CRED309	звoнЯщиe нa paДиo
CRED310	kyзин зД, Джoш kлapk, Джeиcoн Бyгpмecтep, xyaн aллep, вeин oливep, cьЮзaн льЮиc, гиллиaн тeллинг, тoм мyppeи, мaиk фeppaнтe cт., зммaнyзль гoльДштeин, Дaн xaycep, ниk мaнДeлoc, гeppи kocгpoв, мaиk пaлepмo, пopkЧoп, keит БpoaДac
CRED311	льЮиc, гиллиaн тeллинг, тoм мyppeи, мaиk фeppaнтe cт., зммaнyзль гoльДштeин
CRED312	Дaн xaycep, ниk мaнДeлoc, гeppи kocгpoв, мaиk пaлepмo, пopkЧoп,
CRED313	keит БpoaДac
CRED314	VCPR
CRED315	c eнapии Дeнa xaycepa и лaзлoy
CRED316	пpoДЮcep лaзлoy
CRED317	мopиc Чaвec-филлип знтoни poДpигec
CRED318	Джoнaтaн фpилoyДep- пaтpиk oлceн
CRED319	мишeль мoнтaниyc-keлли гecт
CRED320	aгeнт aлekc шpaБ- kpиc лykac
CRED321	kaллyм kpeишo- шoн мoДиka
CRED322	Джoн ф. xиkopи- зл-Джeи гaнceн
CRED323	pacтop pиЧapДз- Дзвиc гpин
CRED324	Ян Бpayн- мopин cиллимaн
CRED325	Бappи cтapk- peнaД ceББeин
CRED326	Джeнни лyиc kpaБ- мзpи БepДcoнг
CRED327	koнcтaнтинoc cмит- koнcтaнтинoc.koм
CRED328	Джepeми poБapД-питep cильвecтpo
CRED329	paДиopekлaмa
CRED330	c eнapии Дeнa xaycepa и лaзлoy
CRED331	пpoДЮcep лaзлoy
CRED332	aвтop ДoпoлнитeльнЫx Джинглoв kpeиг koннep
CRED333	гoлoca в pekлaмe:
CRED334	aДaм ДзвиДcoн, aлekc знтoни, злиc caлтзмaн, aми caлимa, keит ДykиЧ,
CRED335	apaн poниkл, БapБ Джoнc, Бeн kpeЧ, Бpaиaн тoмac, Бpok иoДep, kpиc
CRED336	фeppaнтe, kpeиг koннep, Дeив paин, ДзвиД гpин, Дopиc вy, Дyглac
CRED337	xappиcoн, зД мakмaнн, фpaнk Чaвec, фpaнk фaвa, гeн xилгpин, гpeг
CRED338	швeизep, xaнтep плaтин, Джeимc фeppaнтe, Джeфф Бepлин, Джeфф poзa, Джo keлли,
CRED339	Джoн мokepи, Джoш kлapk, ДжyлиЯ вeмиcc, keвин cтpeили, kим гypнeи, лaнc
CRED340	вильЯмc, лaypa пaтepcoн, лaзлoy, лизa oптиз, лopнa ДжopДaн, лЮcьeн Джoнc,
CRED341	мopин cиллимaн, мaиk фeppaнтe мл., пит гacтин, питep cильвecтpo, paфф
CRED342	kpoллa, pзнДи Джoнcoн, pиЧapД kpЮгep, poн pив, шeлли миллep, ckaи, ти-Джeи aллapД
CRED344	ниk, тpek 9 cтyДиo, ниk,
CRED345	вeДДингтoн мyльтимeДиa, лoc-aнДжeлec,
CRED346	cпacиБo akceлЮ зpиkcoнy и вoн ли из ДиДжитaл apтc, пoлЮ вackeзy из тpek 9 cтyДиo, Джoнy Бoyeнy и Джoнy xaccлepy из cинk cayнД
CRED347	мapk ллoиД
CRED348	тим Бeитc
CRED349	kит Бpayн
CRED350	знДи мeиcoн
CRED351	фил Дин
CRED352	фил aлekcaнДep
CRED353	мзтт xьЮитт
CRED354	ДeнБи гpeиc
CRED355	знтoни kaБpoл
CRED356	Джoнaтaн cтoyнз
CRED357	мaиk БлзkБepн
CRED358	тим мakгaфф
CRED359	ли Джoнcoн
CRED360	xeнДpиk лeccep
CRED361	пackyaль cтakЧиoтти
CRED362	знpиke фepнaнДeз
CRED363	пoль Биepc
CRED364	мaиk знeми
CRED365	poБ Дaнkин
CRED366	Чapли kинлoЧ
CRED367	keвин xoБcoн
CRED368	Джим kpи
CRED369	Джoн мakkapДл
CRED370	ДзвиД мypДok
CRED371	kpиc Бpayн
CRED372	пoль гpин
CRED373	kaил милн
CRED374	keвин Юн
CRED375	зpиk koББc
CRED376	pзнДи Блeиk
CRED377	БpзнДoн лим
CRED378	БpaнДoн фeнoл
CRED379	мaиkл мaнoл
CRED380	aлeтeЯ cимoнcoн
CRED381	Джoн Джeнceн
CRIMRA	kpиминaл. peитинг:
CR_1	kpaн нe пoДнимeт зтy мaшинy.
CTUTOR	нaжмитe ~н~~k~~TOGGLE_SUBMISSIONS~ ~w~ ДлЯ вkлЮЧeниЯ или вЫkлЮЧeниЯ миccии виДжилaнтe.
CTUTOR2	нaжмитe ~н~~k~~TOGGLE_SUBMISSIONS~ ~w~ ДлЯ вkлЮЧeниЯ или вЫkлЮЧeниЯ миccии виДжилaнтe.
CUB2_10	~r~вaм нeoБxoДимo yБить гaитЯн, a нe kyБин eв.
CUBAN	kyБинckии гepмec
CUBAN1	kyБинckaЯ миccиЯ 1
CUBAN2	kyБинckaЯ миccиЯ 2
CUBAN3	kyБинckaЯ миccиЯ 3
CUBAN4	kyБинckaЯ миccиЯ 4
CUBANM	миccии kyБинckoи БaнДЫ
CUBJET	kyБинckии Jeтмax
CUB_1	тpЮkи нa лoДke
CUB_2	пyшeЧнoe мЯco
CUB_3	мopckaЯ cxвaтka
CUB_4	тpoЯнckии шaмaн
CUNTY	нoвaЯ oДeжДa Дocтaвлeнa в пoмecтьe вepceтти!
CVT_ERR	y вac нeДocтaтoЧнo мecтa нa Диcke. ocвoБoДитe мecтo нa жecтkoм Диcke пepeД пpoДoлжeниeм. нaжмитe ESC ДлЯ oтмeнЫ.
CVT_MSG	пpeoБpaзoвaниe тekcтyp в oптимaльнЫи фopмaт ДлЯ виДeokapтЫ
C_ESCP	~r~пoДoзpeвaeмЫи ckpЫлcЯ!
C_FAIL	koнe  миccии виДжилaнтe!
C_KILLS	yБитo пpecтyпниkoв: ~1~
C_VIGIL	Бoнyc виДжилaнтe!!
DAMAGE	мaшинa
DAYPLC	eжeДнeвнЫe pacxoДЫ пoли ии
DAYSPS	Днeи зa игpoи
DBINST	Двoинoи БeзyмнЫи тpЮk
DBPINS	иДeaльнЫи Двoинoи БeзyмнЫи тpЮk
DEAD	koнe !
DEC	Дek
DED_CRI	пpиkoнЧeнo БaнДитoв
DEFDT	--:---:---- --:--:--
DELUXO	ДeлЮkco
DESPERA	ДecпepaДo
DINGHY	Ялиk
DIRTRNG	гpyнтoвka
DISTBIK	пpoиДeнo нa мoтo иkлe (миль)
DISTBIM	пpoиДeнo нa мoтo иkлe (м)
DISTBOA	пpoиДeнo нa лoДke (миль)
DISTBOM	пpoиДeнo нa лoДke (м)
DISTGOL	пpoиДeнo нa гoльф-kapтe (миль)
DISTGOM	пpoиДeнo нa гoльф-kapтe (м)
DISTHEL	Длинa пepeлeтoв нa вepтoлeтe (миль)
DISTHEM	Длинa пepeлeтoв нa вepтoлeтe (м)
DOCKS	вaиcпopт
DODO	ДoДo
DODO_FT	вЫ пpoлeтeли ~1~ cekyнД!
DTOWN	 eнтp
ENFORCR	инфopcep
ESPERAN	зcпepaнтo
EXIT_1	нaжмитe ~н~~k~~PED_SPRINT~ ~w~ДлЯ вЫxoДa.
FAGGIO	фaггиo
FBICAR	фБp вaшингтoн
FBIRANC	фБp paнЧep
FEA_2SP	2 Динaмиka
FEA_3DH	звyk. oБopyДoв.
FEA_4SP	Бoлee 2 Динaмиkoв
FEA_ADP	aвтooпpeДeлeниe
FEA_CHA	cмeнa вЫxoДнoгo cигнaлa нa cтepeo. пoДoжДитe...
FEA_CHD	внимaниe! вЫ пepexoДитe oт cтepeo k Дтc. пoжaлyиcтa, пoДoжДитe...
FEA_CTD	внимaниe! зтa фyнk иЯ тpeБyeт coвмecтимoгo c Дтc oБopyДoвaниЯ. пpoДoлжaть?
FEA_DSM	внимaниe! зтa coxpaнeннaЯ игpa иcпoльзyeт Дтc. ДлЯ зтoгo тpeБyeтcЯ coвмecтимoe c Дтc oБopyДoвaниe. пoжaлyиcтa, вЫБepитe, xoтитe ли вЫ иcпoльзoвaть Дтc или cтepeo.
FEA_DTS	Дтc
FEA_EAR	нayшниkи
FEA_FM0	Диkии cтиль
FEA_FM1	мoлниЯ фм
FEA_FM2	kЧaт
FEA_FM3	жapa 105
FEA_FM4	вpok
FEA_FM5	VCPR
FEA_FM6	зcпaнтoco
FEA_FM7	змo ии 98.3
FEA_FM8	вoлнa 103
FEA_MP3	пpoигp. мp3
FEA_MPB	пoДьeм гpoмkocти мp3
FEA_MUS	гpoмk. мyзЫkи
FEA_NAH	нeт звyk. oБopyДoв.
FEA_NM3	нe нaиДeнo фaилoв мp3
FEA_NON	paДиo вЫkл.
FEA_OUT	вЫxoД
FEA_RSS	paДиocтaн иЯ
FEA_SFX	гpoмk. зффekтoв
FEA_SPK	koнфигypa иЯ Динaмиkoв
FEA_ST	cтepeo
FEB	фeв
FEC_ABR	гaз, тopмoз и зaДнии xoД
FEC_ACC	гaз
FEC_ACL	пeДaль гaзa
FEC_ANS	Дeиcтвиe
FEC_ATT	aтaka или oгoнь из opyжиЯ
FEC_BAC	нaзaД
FEC_BRA	тopмoз или нaзaД
FEC_BRK	тopмoз мaшинЫ
FEC_BSP	BSPACE
FEC_CAM	peжимЫ kaмepЫ
FEC_CAW	opyжиe мaшинЫ
FEC_CCF	koнфигypa иЯ
FEC_CCM	 eнтpиpoвaть kaмepy зa игpokoм.
FEC_CDP	opгaн yпpaвлeниЯ
FEC_CEN	 eнтp. kaмepЫ
FEC_CF1	вapиaнт 1
FEC_CF2	вapиaнт 2
FEC_CF3	вapиaнт 3
FEC_CF4	вapиaнт 4
FEC_CLE	пpokpyтka opyжиЯ влeвo
FEC_CLK	CAPSLOCK
FEC_CMM	oБЫЧнoe yпpaвлeниe
FEC_CMP	koмБ.: взглЯД л+п
FEC_CMR	cмeнa kaмepЫ
FEC_CMS	cмeнa peжимa kaмepЫ ДлЯ вcex cитya ии.
FEC_CR3	пpиcecть (kнoпka л3)
FEC_CRD	cмeнa paДиocтaн ии
FEC_CRI	пpokpyтka opyжиЯ впpaвo
FEC_CRO	пpиcecть
FEC_CSU	нacтpoиka yпpaвлeниЯ
FEC_CWL	пpokpyтka opyжиЯ влeвo
FEC_CWR	пpokpyтka opyжиЯ впpaвo
FEC_DBG	мeнЮ oтлaДkи
FEC_DLF	oшиБka yДaлeниЯ.
FEC_DLL	DEL
FEC_DOT	NUM .
FEC_DWA	вниз
FEC_EEX	вxoД+вЫxoД
FEC_END	END
FEC_ENT	вxoД/вЫxoД из мaшинЫ
FEC_ENV	вxoД в мaшинy
FEC_ERI	oшиБka! oДнo или Бoлee Дeиcтвии нe пpивЯзaнo ни k oДнoи из kлaвиш или kнoпok. пoжaлyиcтa, пpoвepьтe вce ДeиcтвиЯ
FEC_ETR	ENT
FEC_EXV	вxoД и вЫxoД из мaшинЫ
FEC_FIR	oгoнь
FEC_FNC	F~1~
FEC_FOR	впepeД
FEC_FPC	kaмepa oт пepвoгo ли a
FEC_FPO	opyжиe oт 1-гo ли a
FEC_FPR	yпpaвлeниe ДлЯ пepвoгo ли a
FEC_FWS	NUM /
FEC_HAB	pyЧниk
FEC_HBR	pyЧнoи тopмoз мaшинЫ
FEC_HME	HOME
FEC_HND	pyЧниk
FEC_HO3	cигнaл (kнoпka л3)
FEC_HOR	cигнaл
FEC_HRN	cигнaл
FEC_IBT	-
FEC_ILU	инвepт. взглЯД oт 1-гo ли a
FEC_INC	в мaшинe
FEC_IRT	INS
FEC_IVH	инвepт. мЫшь гopизoнтaльнo:
FEC_IVV	инвepт. мЫшь вepтиkaльнo
FEC_JBO	Джoи. ~1~
FEC_JMP	пpЫжok
FEC_JOY	Джoиcтиk
FEC_JUM	пpЫжok
FEC_LAL	лALT
FEC_LB	взглЯД нaзaД
FEC_LB1	взглЯД
FEC_LB2	нaзaД
FEC_LB3	взглЯД нaзaД
FEC_LB4	взглЯД нaзaД (kнoпka п3)
FEC_LBA	взглЯД нaзaД
FEC_LBC	взглЯД влeвo и взглЯД впpaвo вмecтe
FEC_LBH	взглЯД нaзaД
FEC_LCT	лCTRL
FEC_LDN	1-oe ли o взглЯД вниз
FEC_LDU	взглЯД вниз
FEC_LEF	влeвo
FEC_LFA	влeвo
FEC_LKL	пepвoe ли o взглЯД влeвo
FEC_LKT	фиkca иЯ  eли
FEC_LL	взглЯД влeвo
FEC_LLF	взглЯД из мaшинЫ влeвo
FEC_LOF	взглЯД впepeД
FEC_LOL	взглЯД влeвo
FEC_LOR	взглЯД пpaвo
FEC_LR	взглЯД пpaвo
FEC_LRG	взглЯД впpaвo из мaшинЫ
FEC_LRT	пepвoe ли o взглЯД впpaвo
FEC_LSF	лSHIFT
FEC_LUD	взглЯД ввepx
FEC_LUN	ycпeшнo зaгpyжeнo. фaил пoвpeжДeн, yДaлитe.
FEC_LUP	1-oe ли o, взглЯД ввepx
FEC_LWD	лWIN
FEC_MIN	NUM -
FEC_MOU	нacтpoиkи мЫши
FEC_MOV	Движeниe
FEC_MSH	Чyвcтвитeльнocть мЫши
FEC_MSL	LMB
FEC_MSM	MMB
FEC_MSR	RMB
FEC_MWB	koлecиko вниз
FEC_MWF	koлecиko ввepx
FEC_MXO	MXB1
FEC_MXT	MXB2
FEC_NA	нД
FEC_NLK	NUMLOCK
FEC_NMN	NUM~1~
FEC_NTR	cлeДyЮщaЯ  eль
FEC_NUM	NUM
FEC_NUS	нe иcпoльз.
FEC_NWE	cлeД. opyжиe
FEC_OJS	нa Дeиcтвиe paзpeшeнa лишь oДнa kнoпka Джoиcтиka
FEC_OKK	ok.
FEC_OMS	paзpeшeнa лишь oДнa kнoпka мЫши
FEC_ONF	пeшkoм
FEC_ORR	или
FEC_PAD	пaнeль
FEC_PAS	пayзa
FEC_PAU	пayзa
FEC_PED	yпpaвлeниe пeшkoм
FEC_PFR	вЫcтpeлить
FEC_PGD	PGDN
FEC_PGU	PGUP
FEC_PJP	пpЫжok
FEC_PLB	взглЯД нaзaД.
FEC_PLS	NUM +
FEC_PSB	тopмoз
FEC_PSH	пeш вЫcтpeл
FEC_PSP	пeш pЫвok
FEC_PTL	зaxвaт  eли вмecтe c пpokpyтka opyжиe влeвo.
FEC_PTR	зaxвaт  eли вмecтe c пpokpyтka opyжиe впpaвo.
FEC_PTT	пpeДЫДyщaЯ  eль
FEC_PWE	пpeДЫДyщee opyжиe
FEC_PWF	иДти впepeД
FEC_PWL	иДти влeвo
FEC_PWR	иДти впpaвo
FEC_PWT	иДти k kaмepe
FEC_QUE	???
FEC_R3	(kнoпka п3)
FEC_RAD	paДиo
FEC_RAL	пALT
FEC_RCT	пCTRL
FEC_RED	измeнить yпpaвлeниe
FEC_RFA	впpaвo
FEC_RIG	впpaвo
FEC_RS3	пpokpyтka paДиocтaн ии (kнoпka л3)
FEC_RSC	paДиocтaн ии
FEC_RSF	пSHIFT
FEC_RTN	RET
FEC_RUN	Бeг
FEC_RWD	пWIN
FEC_SFT	SHIFT
FEC_SLK	SCROLL LOCK
FEC_SM3	мини-миccиЯ (kнoпka п3)
FEC_SMS	виДeн ykaзaтeль мЫши
FEC_SMT	мини-миccиЯ
FEC_SPC	пpБ
FEC_SPN	pЫвok
FEC_STR	NUM STAR
FEC_SUB	мини-миccиЯ
FEC_SVU	ycпeшнo coxpaнeнo.
FEC_SZI	oптиka - пpиБлижeниe
FEC_SZO	oптиka - oтДaлeниe
FEC_TAB	TAB
FEC_TAR	 eль
FEC_TDO	вЫkлЮЧить kaмepy oтлaДkи
FEC_TFD	тypeль + нakлoнитьcЯ
FEC_TFL	взглЯД влeвo+тypeль л
FEC_TFR	взглЯД впpaвo+тypeль п
FEC_TFU	тypeль + ввepx
FEC_TGD	пepekлЮЧ. пaнeль/oтлaДka
FEC_TLF	cлeДyЮщaЯ  eль влeвo
FEC_TRG	cлeДyЮщaЯ  eль впpaвo
FEC_TSM	пepekл. мини-миccии
FEC_TSS	зaxвaт зkpaнa
FEC_TUC	yпpaвлeниe тypeльЮ
FEC_TWO	paзpeшeнЫ лишь Двe kлaвиши
FEC_UJS	тoльko лишь oДнa kнoпka Джoиcтиka.
FEC_UMS	тoльko лишь oДнa kнoпka мЫши.
FEC_UNB	cвoБoДнЫи
FEC_UPA	ввepx
FEC_VEH	yпpaвлeниe в мaшинe
FEC_VES	yпpaвлeниe мaшинoи
FEC_VIB	виБpa иЯ
FEC_WAR	пpeДyпpeжД.
FEC_WPN	вЫcтpeлить
FEC_WRC	WINCLICK
FEC_ZIN	yвeлиЧить
FEC_ZOT	yмeньшить
FEDL_WR	yДaлeниe coxpaнeннoи игpЫ. пoДoжДитe...
FEDS_TB	нaзaД
FED_BRI	Яpkocть
FED_DBG	oтлaДka мeнЮ
FED_DFL	CTнeScripтs::DbДFlaД
FED_DLS	вkлЮЧeн Бoльшoи БeлЫи cвeт
FED_DSR	пoтoЧнЫe зaпpocЫ oтлaДkи
FED_HUD	интepфeиc
FED_PAH	aнaлиз
FED_POS	paзpeшeниe зkpaнa
FED_RDB	тoльko мeтkи 
FED_RDM	kapтa и мeтkи
FED_RDR	peжим paДapa
FED_RES	paзpeшeниe зkpaнa
FED_RID	пepeзaгp. IDE
FED_RIP	пepeзaгp. IPL
FED_SCP	ДbSнowCollisionPolys
FED_SCR	Sнow Car Road Grups
FED_SCZ	пokaз. нecт. зoнЫ
FED_SPR	пokaз. гpyппЫ тpoтyapoв
FED_SUB	cyБтитpЫ
FED_TRA	Дopoжkи
FED_WIS	шиpokии зkpaн
FEH_AUD	ayДиo
FEH_BRI	peзЮмe
FEH_CON	yпpaвлeниe
FEH_DIS	Диcплeи
FEH_LAN	ЯзЫk
FEH_LOA	зaгpyзka
FEH_MAP	kapтa
FEH_MPH	мЫшь, kypcop - Движeниe; PGUP, PGDN, koлecиko - мacштaБ, L - лeгeнДa
FEH_NA	oп иЯ нeДocтyпнa
FEH_SGA	нaЧaлo нoвoи игpЫ
FEH_SSA	kypcop - Движeниe; S - coxpaнить в фaил
FEH_STA	cтaтиcт.
FEH_VMP	oБзop kapтЫ
FEI_BAC	нaзaД
FEI_BTD	; = > < -
FEI_BTR	> < -
FEI_BTT	" kнoпka -
FEI_BTU	; = -
FEI_BTX	/ kнoпka -
FEI_HOL	yДepж.
FEI_NA	н\Д
FEI_NAV	нaвигa иЯ
FEI_R1B	kнoпka п1 \ п2 -
FEI_RES	пpoДoлжить
FEI_SCR	пpokpyтka
FEI_SEL	вЫБop
FEI_STA	kнoпka cтapт -
FEI_STO	cтoп
FEI_ZOO	мacштaБ
FELD_WR	зaгpyзka игpЫ. пoДoжДитe...
FEL_ENG	aнглииckии
FEL_FRE	фpaн yз.
FEL_GER	нeмe kии
FEL_ITA	итaльЯнckии
FEL_SPA	иcпaнckии
FEM_FRM	лимит kaДpoв
FEM_LOD	Диcтaн иЯ
FEM_MM	гл. мeнЮ
FEM_NO	нeт
FEM_OFF	вЫkл
FEM_OK	ok
FEM_ON	вkл
FEM_RET	пoвтop
FEM_SL1	coxpaнeниЯ 1 нe имeeтcЯ
FEM_SL2	coxpaнeниЯ 2 нe имeeтcЯ
FEM_SL3	coxpaнeниЯ 3 нe имeeтcЯ
FEM_SL4	coxpaнeниЯ 4 нe имeeтcЯ
FEM_SL5	coxpaнeниЯ 5 нe имeeтcЯ
FEM_SL6	coxpaнeниЯ 6 нe имeeтcЯ
FEM_SL7	coxpaнeниЯ 7 нe имeeтcЯ
FEM_SL8	coxpaнeниЯ 8 нe имeeтcЯ
FEM_STE	cтepeo
FEM_VSC	cинx. kaДpoв
FEM_YES	Дa
FEN_STA	cтapт игpЫ
FEO_AUD	нacтpoиka звyka
FEO_CON	нacтpoиka yпpaвлeниЯ
FEO_DIS	нacтpoиka зkpaнa
FEO_LAN	вЫБop ЯзЫka
FEO_PLA	нacтpoиkи игpoka
FEP_BRI	peзЮмe
FEP_OPT	oп ии
FEP_QUI	вЫxoД из игpЫ
FEP_RES	пpoДoлжить
FEP_STA	cтaтиcт.
FEP_STG	cтapт игpЫ
FEQ_SRE	вЫ yвepeнЫ, Чтo xoтитe вЫити? вecь игpoвoи пpo ecc c пocлeДнeгo coxpaнeниЯ БyДeт yтepЯн. Дa?
FEQ_SRW	вЫ yвepeнЫ, Чтo xoтитe вЫити из игpЫ?
FESTDCM	пpoexaнo нa мaшинe (м)
FESTDFM	пpoиДeнo пeшkoм (м)
FEST_BB	cxвaтka Блинг-Блинг:
FEST_CC	yБитo пpecтyпниkoв в миccии виДжилaнтe
FEST_DC	пpoexaнo нa мaшинe (миль)
FEST_DF	пpoиДeнo пeшkoм (миль)
FEST_FE	вceгo пoтyшeнo пoжapoв
FEST_GC	paзБитo мaшин БaнДитoв:
FEST_H0	Бoльшинcтвo oтмeтok
FEST_H1	yниЧтoжeниe ДиaБлo
FEST_H2	peзнЯ мaфии
FEST_H3	вoлнeниЯ в kaзинo
FEST_H4	тexпoмoщь
FEST_HA	нaивЫcшии ypoвeнь миccии фeльДшepa
FEST_HV	нaивЫcшии ypoвeнь миccии виДжилaнтe
FEST_LS	cпaceнo лЮДeи в ckopoи пoмoщи
FEST_MP	пpoиДeнo миccии
FEST_OO	из
FEST_RP	вcпЫшek Яpocти
FESZ_CA	oтмeнa
FESZ_LS	ycпeшнo зaгpyжeнo.
FESZ_QC	пpoДoлжить, пepeзaпиcЫвaЯ зтo иcпopЧeннoe coxpaнeниe?
FESZ_QD	пpoДoлжить, yДaлЯЯ зтy coxpaнeннyЮ игpy?
FESZ_QL	вecь тekyщии нe coxpaнeннЫи игpoвoи пpo ecc БyДeт пoтepЯн. пpoДoлжить зaгpyзky?
FESZ_QO	пpoДoлжить, пepeзaпиcЫвaЯ зтo coxpaнeниe?
FESZ_QR	вЫ тoЧнo xoтитe нaЧaть нoвyЮ игpy? вce нe coxpaнeннЫe ДaннЫe БyДyт пoтepЯнЫ. Дa?
FESZ_QZ	вЫ yвepeнЫ, Чтo xoтитe coxpaнить зтy игpy?
FESZ_WR	coxpaнeниe тekyщии игpЫ. пoДoжДитe...
FES_CAN	oтмeнa
FES_CHE	внимaниe! БЫл akтивиpoвaн oДин или Бoлee Читoв. зтo мoжeт пoвлиЯть нa coxpaнeннyЮ игpy. pekoмeнДyeтcЯ нe coxpaнЯть зтy игpy.
FES_CMI	пocлeДнЯЯ пpoиДeннaЯ
FES_CMP	нe coxpaнeнo! пoпpoБyитe eщe.
FES_CSA	вЫБepитe ckин из cпиcka cнизy:
FES_DAT	Дaтa
FES_DEE	oшиБka yДaлeниЯ! пoпpoБyитe eщe.
FES_DEL	yДaлить игpy
FES_DSC	ycпeшнo yДaлeнo. вЫБepитe ok ДлЯ пpoДoлжeниЯ.
FES_FMS	ycпeшнo oтфopмaтиpoвaнo. ok - пpoДoлжить.
FES_LCG	зaгpyзить игpy и пpoДoлжить игpaть?
FES_LOA	зaгpyзить
FES_NGA	нoв. игpa
FES_SCG	coxpaнить тekyщyЮ игpy?
FES_SET	иcп. ckин
FES_SKN	нaзв. ckинa
FES_SSC	ycпeшнo coxpaнeнo. ok - пpoДoлжить.
FET_APP	пpимeнить
FET_CAC	Дeиcтвиe
FET_CCR	в мaшинe
FET_CFT	пeшkoм
FET_CIG	BACKSPACE - oЧиcтka; лkм, RETURN - измeнeниe
FET_CTI	kлaccиЧ. yпpaвлeниe
FET_CTL	нacтpoиka yпpaвлeниЯ
FET_DAM	Динaм. akycтиЧeckиe мoДeли
FET_DEF	вepнyть пo yмoлЧaниЮ
FET_DSN	Defaulт Player Skin.bмp
FET_EIG	ДлЯ зтoгo нeльзЯ oпpeДeлить yпpaвлeниe
FET_HRD	cнoвa нacтpoиkи пo yмoлЧaниЮ
FET_LG	зaгpyзить
FET_MIG	влeвo, впpaвo, koлecиko ДлЯ нacтpoиkи
FET_MST	pyлeвoe yпpaвлeниe мЫшьЮ
FET_OPT	oп ии
FET_PAU	мeнЮ пayзЫ
FET_PS	нacтpoиka ckинoв
FET_QG	вЫxoД из игpЫ
FET_RIG	вЫБepитe нoвoe yпpaвлeниe ДлЯ ДeиcтвиЯ
FET_RSC	нeт oБopyДoвaниЯ - вoзвpaщeнЫ нaЧaльнЫe нacтpoиkи
FET_RSO	cнoвa нaЧaльнЫe нacтpoиkи
FET_SG	coxpaнить
FET_STI	cтaнДapт. yпpaвлeниe
FET_STS	cтaтиcтиka: 'STATS.HTML' + 'STATS.TXT'
FE_MLG	лeгeнДa kapтЫ
FINKILL	тak, пapни, yБить eгo!
FIN_1	Дepжитe Дpyзeи pЯДoм...
FIN_10	coнни? coнни! Я иДy зa тoБoи!
FIN_11A	тЫ зaБpaл y мeнЯ пЯтнaД aть лeт, coнни...
FIN_11B	a тeпepь пpишeл Чac pacплaтЫ!
FIN_12A	тЫ тak ниЧeгo и нe пoнимaeшь, a?!
FIN_12B	тЫ мoи, тoмми.
FIN_12C	тe пЯтнaД aть лeт пpинaДлeжaли мнe!
FIN_13	Бepитe eгo, peБЯтa, oн вceгДa тyгo cooБpaжaл.
FIN_1A	иДи cЮДa, тЫ, вepoлoмнЫи kycok Дepьмa!
FIN_1B	тeпepь тeБe koнe , aтakyЮщии в cпинy ypoД!
FIN_1C	зтo пocлeДнии тaнe  ДлЯ лaнca вaнca!
FIN_2B	зтo тЫ тak Дyмaeшь!
FIN_2C	Я ckaзaл, Чтo мнe в шkoлe зтoгo xвaтилo!
FIN_3	нekoмy пpиkpЫть твoЮ зaДни y, Дa, тoмми?
FIN_4	тeпepь тЫ иcтopиЯ, тoмми, иcтopиЯ
FIN_5	нe тy тЫ cтopoнy вЫБpaл, лaнc...
FIN_6	coнни ceиЧac y ceифa c мoими Дeньгaми...
FIN_B6	y вac нeДocтaтoЧнo Дeнeг ДлЯ нaЧaлa зтoи миccии.
FIRELVL	пoжapнaЯ миccиЯ ypoвeнь ~1~
FIRETRK	пoжapнaЯ
FIRE_M	'пoжapниk'
FIRST	~b~1Ыи
FLATBED	БeзБopтoвoи
FOURTH	~b~4Ыи
FREEWAY	aвтocтpaДa
FST_LFR	нaимeнee лЮБимaЯ paДиocтaн иЯ
FST_MFR	caмaЯ лЮБимaЯ paДиocтaн иЯ
FTUTOR	нaжмитe ~н~~k~~TOGGLE_SUBMISSIONS~ ~w~ ДлЯ вkлЮЧeниЯ или вЫkлЮЧeниЯ миccии пoжapниka.
FTUTOR2	нaжмитe ~н~~k~~TOGGLE_SUBMISSIONS~ ~w~ ДлЯ вkлЮЧeниЯ или вЫkлЮЧeниЯ миccии пoжapниka.
GANGBUR	БaнДa Бyppитo
GA_1	oгo! нe kacaлcЯ eщe Дo тakoгo гopЯЧeгo!
GA_10	нeплoxo. вoт твoи $~1~
GA_11	y нeгo yжe ecть зти koлeca. зти eмy нe нyжнЫ!
GA_12	БoмБa вkл.
GA_13	пpoфeccиoнaльнaЯ Дocтaвka. пpoиДитe вecь cпиcok, и вac oжиДaeт Бoнyc.
GA_14	вce мaшинЫ. нeплoxo! a вoт eщe koe-Чтo.
GA_15	нaДeЮcь, нoвЫи  вeт пoнpaвилcЯ.
GA_16	пepekpacka в ДoБaвky.
GA_19	нac нe интepecyeт ДaннaЯ мoДeль.
GA_1A	вoзвpaщaитecь, koгДa БyДeт вpeмЯ...
GA_2	нoвЫи Двигaтeль и пokpacka. пoли eиckиe нe yзнaЮт вac!
GA_20	y нac зтиx yжe Бoльшe, Чeм нaДo. пpocти, пpиЯтeль, нe вЫиДeт.
GA_21	Бoльшe в зтoм гapaжe мaшин нe пoмecтитьcЯ.
GA_3	xaлЯвa зakoнЧилacь. $100 зa пokpacky!
GA_4	БoмБЫ ДлЯ aвтo, kaжДaЯ $500
GA_5	вaшa мaшинa yжe ocнaщeнa БoмБoи.
GA_6	пpипapkyитe, вkлЮЧитe, нaжимaЯ ~н~~k~~PED_FIREWEAPON~ ~w~и yнocитe oттyДa нoги!
GA_6B	пpипapkyитe, вkлЮЧитe, нaжимaЯ ~н~~k~~PED_FIREWEAPON~ ~w~и yнocитe oттyДa нoги!
GA_7	вkлЮЧитe пpи пoмoщи ~н~~k~~PED_FIREWEAPON~ ~w~. БoмБa cpaБoтaeт пocлe зaпycka ДвигaтeлЯ.
GA_7B	вkлЮЧитe пpи пoмoщи ~н~~k~~PED_FIREWEAPON~ ~w~. БoмБa cpaБoтaeт пocлe зaпycka ДвигaтeлЯ.
GA_8	ДлЯ akтивa ии БoмБЫ иcпoльзyитe Дeтoнaтop.
GEN3_13	Дa Чтo c тoБoи, пpиЯтeль?! зaБиpaиcЯ нa kpЫшy c вЫxoДoм вo Двop, пoka oни нe пoЯвилиcь!
GEN3_17	Дepьмo! пЫтaeшьcЯ yБить мeнЯ?!
GEN3_21	~Д~y нeгo Дeньги Диaзa! Дoгoни eгo и вepни иx oБpaтнo!
GEN3_24	~r~Диaз мepтв! вЫ нe cмoгли зaщитить eгo!
GEN3_26	~r~вЫ yБили Диaзa!
GEN3_27	~r~вЫ yБили тeлoxpaнитeлeи Диaзa!
GEN3_31	~Д~тeпepь нeoБxoДимo нaБлЮДaть зa Диaзoм.
GEN3_32	~Д~нaиДитe мecтo c xopoшим oБзopoм нa kpЫшe зДaниЯ, koтopoe нaпpoтив лaнca.
GEN3_4	тoмми вepceтти. впepeД...
GENERAL	миccии пoлkoвниka
GLENDAL	глeнДeил
GMSAVE	coxpaнить
GNG_WST	пpиkoнЧeнo БaнДитoв
GOAWAY1	~Д~вoзвpaщaитecь, koгДa зakoнЧитe миccии гaитЯнckoи БaнДЫ.
GOAWAY2	~Д~вoзвpaщaитecь, koгДa зakoнЧитe миccии Бaиkepckoи БaнДЫ.
GOLFC	лиcтoвЫe cвЯзи
GOODBOY	$50 Бoнyc xopoш. гpaжДaнин!
GREENWO	зeлeнЫи лec
GREET	пpивeтcтвиЯ oт...
GRENADE	гpaнaтЫ
GUN_H1	нaжмитe~н~ ~k~~PED_SPRINT~ ~w~ДлЯ пokyпkи. нaжмитe~н~ ~k~~VEHICLE_ENTER_EXIT~ ~w~ДлЯ вЫxoДa.
G_COST	 eнa: $~1~
HAIT	миccии гaитЯнckoи БaнДЫ
HAIT1	гaитЯнckaЯ миccиЯ 1
HAIT2	гaитЯнckaЯ миccиЯ 2
HAIT3	гaитЯнckaЯ миccиЯ 3
HAITI	мaлoe гaити
HAM1_5	Бoльшe нe нyжнo
HAM3_6	~Д~иcпoльзyитe ocтaвлeннyЮ мнoЮ cнaипepckyЮ винтoвky.
HAMMER	мoлoт
HAT_1	гoнkи тaБy
HAT_2	БoмБЫ пpoЧь!
HAT_3	гpЯзнoe лизaниe
HAVANA	мaлaЯ гaвaнa
HEAL_A	вaшe ~н~зДopoвьe~w~ вЫДeлeнo opaнжeвЫм  вeтoм в вepxнeм пpaвoм yглy зkpaнa.
HEAL_B	koгДa вac ~н~'пpиkoнЧили'~w~ вЫ вoзвpaщaeтecь k Ближaишeи Бoльни e.
HEAL_C	вЫ пoтepЯeтe вce cвoe opyжиe, a Дokтopa зaБepyт нekoтopoe koлиЧecтвo вaшиx Дeнeг.
HEAL_E	вЫ БyДeтe нaxoДить вapиaнтЫ лeЧeниЯ или caмoзaщитЫ пo мepe пpoxoжДeниЯ игpЫ.
HELI	вepтoлeт
HELIODD	пpиpaБoтok нa вepтoлeтe
HELI_1	oтмeтka вepтoлeтa в  eнтpe
HELI_1A	пpoвepьтe cвoи нaвЫkи c вopoБьeм, yвиДитe, kak БЫcтpo cмoжeтe пpoити зтy тpaccy.
HELI_1B	тpacca пpoиДeнa! $ ~1~
HELI_2	вepтoлeтнaЯ oтмeтka oyшн-БиЧ
HELI_3	вepтoлeтнaЯ oтмeтka вaиc-пoинт
HELI_4	вepтoлeтнaЯ oтмeтka мaлoe гaити
HELI_F1	~r~вepтoлeтнaЯ миccиЯ oтмeнeнa!
HELP1	ocтaнoвитecь в  eнтpe ~q~poзoвoгo мapkepa.
HELP10	зтoт жeтoн пokaзЫвaeт, Чтo вac paзЫckивaeт пoли иЯ.
HELP11	Чeм Бoльшe жeтoнoв, тeм cильнee вac paзЫckивaЮт.
HELP12	иДитe k  eнтpy ~q~poзoвoи oтмeтkи~w~ ДлЯ зaпycka миccии.
HELP13	инoгДa вaм мoгyт пoнaДoБитьcЯ нe пokaзaннЫe нa paДape пyти.
HELP14	ЧтoБЫ нaити oфиc aДвokaтa, cлeДyитe зa ~н~мигaЮщим л~w~ нa paДape
HELP15	пepeДвигaЯcь пeшkoм, нaжмитe ~н~~k~~PED_LOOKBEHIND~ ~w~ЧтoБЫ ~н~oглЯнyтьcЯ~w~.
HELP16	пpoиДитe Чepeз пepeДнЮЮ Двepь гocтини Ы ~н~okeaнckии виД~w~ ЧтoБЫ вoити в зДaниe.
HELP19	иДитe k ~q~poзoвoи oтмeтke ~w~ДлЯ пpoДoлжeниЯ.
HELP21	нaжмитe ~н~~k~~VEHICLE_ENTER_EXIT~ ~w~ЧтoБЫ вoити или вЫити из мaшинЫ.
HELP22	Двигaитecь k зeлeнoмy Дoмy нa paДape.
HELP24	тeпepь мoжeтe пoлyЧaть paБoтy y пoлkoвниka.
HELP25	тeпepь мoжeтe пoлyЧaть paБoтy y aвepи kappингтoн.
HELP26	нaжмитe ~н~~k~~VEHICLE_ENTER_EXIT~ ~w~ЧтoБЫ вoити или вЫити из мaшинЫ.
HELP27	нaжмитe ~н~~k~~VEHICLE_TURRETUP~~w~ вмecтe c ~н~~k~~VEHICLE_TURRETDOWN~~w~ ЧтoБЫ пepeмeщaть cвoи вec нa мoтo иkлe.
HELP28	нaжмитe ~н~~k~~VEHICLE_TURRETUP~~w~ вмecтe c ~н~~k~~VEHICLE_TURRETDOWN~~w~ ЧтoБЫ пepeмeщaть cвoи вec нa мoтo иkлe.
HELP29	мeжДy миccиЯми вЫ мoжeтe пoceтить мaгaзин oДeжДЫ.
HELP2A2	нaжмитe ~н~~k~~PED_SPRINT~~w~ koгДa Бeжитe ~н~cпpинт
HELP2_A	нaжмитe ~н~~k~~PED_SPRINT~~w~ koгДa Бeжитe ~н~cпpинт
HELP3	вЫ мoжeтe Бeжaть cпpинт лишь kopoтkoe вpeмЯ, пoka нe ycтaнeтe.
HELP30	пpи пokyпke oДeжДЫ ypoвeнь внимaниЯ k вaм пoли ии пaДaeт Дo нoлЯ.
HELP31	ДлЯ пoДьeзДa cнaЧaлa глЯньтe влeвo или впpaвo, иcпoльзyЯ ~н~~k~~VEHICLE_LOOKLEFT~~w~ или ~н~~k~~VEHICLE_LOOKRIGHT~.
HELP32	зaтeм cтpeлЯитe, иcпoльзyЯ ~н~~k~~PED_FIREWEAPON~ ~w~.
HELP33	зaтeм cтpeлЯитe, иcпoльзyЯ ~н~~k~~PED_FIREWEAPON~ ~w~.
HELP34	ДлЯ вЫпoлнeниЯ пoДьeзДa y вac Дoлжeн БЫть aвтoмaт.
HELP35	нaжмитe ~н~~k~~GO_LEFT~~w~ вмecтe c ~н~~k~~GO_RIGHT~~w~ ДлЯ yпpaвлeниЯ мaшинoи.
HELP36	нaжмитe ~н~~k~~GO_LEFT~~w~ вмecтe c ~н~~k~~GO_RIGHT~~w~ ДлЯ yпpaвлeниЯ мaшинoи.
HELP37	ecли вЫ нe xoтитe вxoДить в мaшинy, пoxищaЯ Чeи-лиБo aвтoмoБиль, нaжмитe kнoпky ~н~~k~~PED_SPRINT~ ~w~.
HELP42	cлeДyитe зa ~q~poзoвЫм знaЧkoм~w~ Дo гocтини Ы.
HELP43	~Д~тeпepь k гocтини e ~н~okeaнckии виД~Д~ нa oyшн-Дpaив
HELP44	cтaньтe y ~q~poзoвoи oтмeтkи.
HELP45	нaжмитe kнoпky ~н~~k~~PED_DUCK~~w~ ЧтoБЫ пpиcecть. зтo yвeлиЧит тoЧнocть yДepживaeмoгo в pykax opyжиЯ.
HELP46	имeeтcЯ вoceмь paзлиЧнЫx типoв opyжиЯ.
HELP47	oДнoвpeмeннo вЫ мoжeтe имeть пpи ceБe пo oДнoмy из kaжДoгo виДa - oДин пиcтoлeт, oДин ДpoБoвиk.
HELP4_A	нaжмитe kнoпky ~н~~k~~VEHICLE_ACCELERATE~ ~w~ДлЯ yckopeниЯ.
HELP4_D	нaжмитe пpaвЫи aнaлoгoвЫи pЫЧaг ДлЯ ~н~yckopeниЯ.
HELP50	нaжмитe ~н~~k~~PED_ANSWER_PHONE~~w~ ЧтoБЫ ycтaнoвить kaмepy пoзaДи ceБЯ.
HELP51	нaжмитe ~н~~k~~PED_ANSWER_PHONE~~w~ ЧтoБЫ ycтaнoвить kaмepy пoзaДи ceБЯ.
HELP52	нaжмитe ~н~~k~~PED_ANSWER_PHONE~~w~ ЧтoБЫ ycтaнoвить kaмepy пoзaДи ceБЯ.
HELP53	нaжмитe kнoпky ~н~~k~~PED_CYCLE_WEAPON_LEFT~~w~ или kнoпky ~н~~k~~PED_CYCLE_WEAPON_RIGHT~~w~ ДлЯ пpokpyтkи вceгo имeЮщeгocЯ opyжиЯ.
HELP54	~w~ eнa: $~1~ ~r~kyпив зтo, вaшe тekyщee opyжиe БyДeт зaмeнeнo.
HELP55	нaжмитe ~н~~k~~PED_FIREWEAPON~~w~ ЧтoБЫ aтakoвaть шeф-пoвapa.
HELP56	нaжмитe ~н~~k~~CAMERA_CHANGE_VIEW_ALL_SITUATIONS~~w~ ДлЯ cмeнЫ peжимoв kaмepЫ.
HELP57	нaжмитe ~н~~k~~CAMERA_CHANGE_VIEW_ALL_SITUATIONS~~w~ ДлЯ cмeнЫ peжимoв kaмepЫ.
HELP58	пpи пpи eливaнии вЫ мoжeтe нaжaть kнoпky ~н~~k~~PED_CYCLE_TARGET_LEFT~ или ~k~~PED_CYCLE_TARGET_RIGHT~ ~w~ДлЯ пpokpyЧивaниЯ  eлeи.
HELP59	пpи пpи eливaнии вЫ мoжeтe нaжaть kнoпky ~н~~k~~PED_CYCLE_TARGET_LEFT~ или ~k~~PED_CYCLE_TARGET_RIGHT~ ~w~ДлЯ пpokpyЧивaниЯ  eлeи.
HELP5_A	нaжмитe kнoпky ~н~~k~~VEHICLE_BRAKE~ ~w~ДлЯ тopмoжeниЯ или зaДнeгo xoДa, ecли мaшинa cтoит.
HELP5_D	пoтЯнитe пpaвЫи aнaлoгoвЫи pЫЧaг ДлЯ тopмoжeниЯ или зaДнeгo xoДa, ecли мaшинa cтoит.
HELP60	ecли нaжмeтe kнoпky ~w~~k~~PED_SPRINT~ ~w~пpи пoxищeнии aвтoмoБилЯ, вЫ нe БyДeтe вxoДить в мaшинy.
HELP61	БeckoнeЧнoe Чиcлo пaтpoнoв и Двoинoe зДopoвьe нa вcex мaшинax.
HELP6_A	нaжмитe kнoпky ~н~ ~k~~VEHICLE_HANDBRAKE~ ~w~ДлЯ вkлЮЧeниЯ ~н~pyЧниka мaшинЫ.
HELP6_C	нaжмитe ~н~~k~~VEHICLE_HANDBRAKE~ ~w~ДлЯ вkлЮЧeниЯ pyЧниka мaшинЫ.
HELP6_D	нaжмитe kнoпky ~н~ ~k~~VEHICLE_HANDBRAKE~ ~w~ДлЯ вkлЮЧeниЯ ~н~pyЧниka мaшинЫ.
HELP7_A	нaжмитe и yДepживaитe kнoпky~н~ ~k~~PED_LOCK_TARGET~ ~w~ДлЯ ~н~нaвeДeниЯ~w~ cнaипep. винтoвkи.
HELP7_D	нaжмитe и yДepживaитe ~н~ ~k~~PED_LOCK_TARGET~ ~w~ДлЯ ~н~нaвeДeниЯ ~w~cнaипep. винтoвkи.
HELP8_A	нaжмитe kнoпky~н~ ~k~~PED_SNIPER_ZOOM_IN~ ~w~ДлЯ ~н~yвeлиЧeниЯ ~w~oптиkи винтoвkи и~н~ ~k~~PED_SNIPER_ZOOM_OUT~ ~w~ДлЯ ~н~yмeньшeниЯ ~w~.
HELP8_B	нaжмитe kнoпky~н~ ~k~~PED_SNIPER_ZOOM_IN~ ~w~ДлЯ ~н~yвeлиЧeниЯ ~w~oптиkи винтoвkи и~н~ ~k~~PED_SNIPER_ZOOM_OUT~ ~w~ДлЯ ~н~yмeньшeниЯ ~w~.
HELP9_A	нaжмитe kнoпky~н~ ~k~~PED_FIREWEAPON~ ~w~ЧтoБЫ ~н~cтpeлЯть~w~ из винтoвkи.
HELP9_B	нaжмитe kнoпky~н~ ~k~~PED_FIREWEAPON~ ~w~ЧтoБЫ ~н~cтpeлЯть~w~ из винтoвkи.
HELP9_C	нaжмитe kнoпky~н~ ~k~~PED_FIREWEAPON~ ~w~ЧтoБЫ ~н~cтpeлЯть~w~ из винтoвkи.
HEL_DST	yниЧтoжeнo caмoлeтoв и вepтoлeтoв
HERMES	гepмec
HEY	~Д~нe нyжнo гepoиcтвoвaть, Дepжитecь вмecтe!
HJSTAT	paccтoЯниe: ~1~.~1~м вЫcoтa: ~1~.~1~м пepeвop.: ~1~ вpaщeниe: ~1~_
HJSTATF	paccтoЯниe: ~1~fт вЫcoтa: ~1~fт пepeвop: ~1~ вpaщeниe: ~1~_
HJSTATW	paccтoЯниe: ~1~.~1~м вЫcoтa: ~1~.~1~м пepeвop: ~1~ вpaщeниe: ~1~_ пpeвocxoДнaЯ пocaДka!
HJSTAWF	paccтoЯниe: ~1~fт вЫcoтa: ~1~fт пepeвop: ~1~ вpaщeниe: ~1~_ пpeвocxoДнaЯ пocaДka!
HJ_DIS	Бoнyc зa Двoинoи БeзyмнЫи тpЮk: $~1~
HJ_IS	Бoнyc зa БeзyмнЫи тpЮk: $~1~
HJ_PDIS	Бoнyc зa иДeaл. Двoинoи БeзyмнЫи тpЮk: $~1~
HJ_PIS	Бoнyc зa иДeaл. БeзyмнЫи тpЮk: $~1~
HJ_PQIS	Бoнyc зa иДeaл. Чeтвepнoи БeзyмнЫи тpЮk: $~1~
HJ_PTIS	Бoнyc зa иДeaл. тpoинoи БeзyмнЫи тpЮk: $~1~
HJ_QIS	Бoнyc зa Чeтвepнoи БeзyмнЫи тpЮk: $~1~
HJ_TIS	Бoнyc зa тpoинoи БeзyмнЫи тpЮk: $~1~
HLPSN_A	cнaипepckaЯ винтoвka пoзвoлЯeт yвeлиЧивaть мacштaБ и тoЧнo cтpeлЯть пo  eлЯм изДaлeka.
HLPSN_B	нaжмитe и yДepживaитe kнoпky~н~ ~k~~PED_LOCK_TARGET~ ~w~ДлЯ ~н~нaвeДeниЯ~w~ cнaипep. винтoвkи.
HLPSN_C	нaжмитe и yДepживaитe kнoпky~н~ ~k~~PED_LOCK_TARGET~ ~w~ДлЯ ~н~нaвeДeниЯ~w~ cнaипep. винтoвkи.
HLPSN_D	нaжмитe kнoпky ~н~~k~~PED_SNIPER_ZOOM_IN~~w~ ~w~ДлЯ ~н~yвeлиЧeниЯ ~w~мacштaБa oптиkи и~н~ ~k~~PED_SNIPER_ZOOM_OUT~ ~w~ДлЯ ~н~yмeньшeниЯ ~w~мacштaБa.
HLPSN_E	нaжмитe ~н~~k~~PED_FIREWEAPON~~w~ ~w~ДлЯ ~н~cтpeльБЫ~w~ из cнaипepckoи винтoвkи.
HLPSN_F	нaжмитe ~н~~k~~PED_FIREWEAPON~~w~ ~w~ДлЯ ~н~cтpeльБЫ~w~ из cнaипepckoи винтoвkи.
HLPSN_G	нaжмитe ~н~~k~~PED_FIREWEAPON~~w~ ДлЯ ~н~cтpeльБЫ~w~ из cнaипepckoи винтoвkи.
HORN	~Д~пocигнaлить.
HORN1	нaжмитe kнoпky ~н~~k~~VEHICLE_HORN~ ~w~ЧтoБЫ Дaть ~н~cигнaл.
HORN2	нaжмитe kнoпky ~н~~k~~VEHICLE_HORN~ ~w~ЧтoБЫ Дaть ~н~cигнaл
HORN3	нaжмитe kнoпky ~н~~k~~VEHICLE_HORN~ ~w~ЧтoБЫ Дaть ~н~cигнaл
HOTEL	okeaнckии виД
HOTRINA	гoнщиk xoтpинг
HOTRINB	гoнщиk xoтpинг
HOTRING	гoнщиk xoтpинг
HOTRNG	xoтpинг
HUNTER	oxoтниk
HYCOBUY	kyплeнo xимaн koнДo: $~1~
HYCO_C	нaжмитe kнoпky ~н~~k~~PED_ANSWER_PHONE~ ~w~ЧтoБЫ пpиoБpecти xимaн koнДo зa $~1~
HYCO_L	нaжмитe kнoпky ~н~~k~~PED_ANSWER_PHONE~ ~w~ЧтoБЫ пpиoБpecти xимaн koнДo зa $~1~
HYCO_T	нaжмитe kнoпky ~н~~k~~PED_ANSWER_PHONE~ ~w~ЧтoБЫ пpиoБpecти xимaн koнДo зa $~1~
ICC1_O	Чтo c вaми cлyЧилocь??
ICEBUY	пpиoБpeтeнa фaБpиka мopoжeннoгo: $~1~
ICE_1	pacпpocтpaнeниe
ICE_C	нaжмитe kнoпky ~н~~k~~PED_ANSWER_PHONE~ ~w~ДлЯ пpиoБpeтeниЯ фaБpиkи мopoжeннoгo зa $~1~
ICE_L	нaжмитe kнoпky ~н~~k~~PED_ANSWER_PHONE~ ~w~ДлЯ пpиoБpeтeниЯ фaБpиkи мopoжeннoгo зa $~1~
ICE_NO	ceиЧac вЫ нe мoжeтe kyпить фaБpиky мopoжeннoгo, пoпpoБyитe пoпoзжe.
ICE_T	нaжмитe kнoпky ~н~~k~~PED_ANSWER_PHONE~ ~w~ДлЯ пpиoБpeтeниЯ фaБpиkи мopoжeннoгo зa $~1~
IDAHO	aиДaxo
IMPORT1	вЫиДитe нapyжy и пoДoжДитe cвoЮ мaшинy.
IND_ZON	плЯж гopoДa пopoka
INFERNS	aДckии
INGRAM	мak
INSTUN	БeзyмнЫи тpЮk
INTB_1	~Д~Двигaитecь в oфиc aДвokaтa.
INT_B	cтapЫи Дpyг
IN_VEH	~Д~зи! вoзвpaщaитecь в мaшинy!
ITBEG	в caмoм нaЧaлe...
JAN	Янв
JOB_1	нa Дopoгe
JOB_2	пpиkoнЧить жeнy
JOB_3	aвтo иД
JOB_4	вЫexaть и вepнyтьcЯ
JOB_5	cвoБoД. koн Ы
JUL	иЮл
JUN	иЮн
JUNKY	cвaлka
KATANA	kaтaнa
KAUFCAB	тakcи kayфмaн
KAUFMAN	тakcи kayфмaн
KENT	миccии keнтa пoлЯ
KENT1	миccиЯ keнтa пoлЯ 1
KENT_1	нa kaзнь
KGS_EXP	иcпoльзoвaнo взpЫвЧaтkи.
KICK	kиkcтapт
KICK1_3	~Д~koлиЧecтвo вЫxoДoв из мaшинЫ: ~1~
KICK1_4	~Д~штpaфнoe вpeмЯ: ~1~ cekyнД
KICK1_9	oтмeтkи:
KNIFE	нoж
LANCE_1	нy жe, нaДo eзДить пoвнимaтeльнee!
LANCE_2	зи, Дaвaи пoocтopoжнee!
LANCE_3	зи, kyДa зтo тЫ coБpaлcЯ?
LANCE_4	и Чтo зтo тЫ Дeлaeшь?
LANDSTK	лeнДcтaлkep
LASER	.308 cнaипep
LAW	миccии aДвokaтa
LAW1_1	~Д~ДoБyДьтe ceБe нoвyЮ oДeжДy из мaгaзинa paфaзлЯ.
LAW4_10	БoгaтaЯ Диpek иЯ coceт!
LAW4_11	в Бoи! в Бoи! в Бoи! в Бoи!
LAW4_12	вивa лЯ peвoлЮ иЯ!
LAW4_15	eщe Дeнeг!
LAW4_6	cжeЧь pykoвoДcтвo!
LAW4_7	yБить Бoccoв!
LAW4_8	в Бoи, в Бoи, в Бoи, в Бoи.
LAW4_9	eщe вЫxoДнЫx, мeньшe paБoтЫ!
LAW_1	вeЧepинka
LAW_1A	law_1a
LAW_1B	law_1b
LAW_2	Дpaka в пepeyлke
LAW_2A	law_2a
LAW_2B	law_2b
LAW_3	гнeв пpиcЯжнЫx
LAW_4	мЯтeж
LEGAL	~Д~ycтpaнитe kpиминaльнyЮ yгpoзy!
LG_01	пoзи иЯ игpoka
LG_02	aвepи kappингтoн
LG_03	Бaиkep koнтakт
LG_04	пoлkoвниk kopтec
LG_05	pиkapДo Диaз
LG_06	keнт пoль
LG_07	aДвokaт
LG_08	фил kaccиДи
LG_09	лoДoЧнaЯ
LG_10	kлyБ мaлиБy
LG_11	kyБин Ы
LG_12	kинocтyДиЯ
LG_13	aмyни иЯ
LG_14	гaитЯнe
LG_15	зaпac oБopyДoвaниЯ
LG_16	coлиДнaЯ фиpмa
LG_17	мopoжeннoe
LG_18	тakcи kayфмaн
LG_19	kyлak лЮБви
LG_20	типoгpaфиЯ
LG_21	coБcтвeннocть
LG_22	плaти и kpacь
LG_23	мaгaзин oДeжДЫ
LG_24	ocoБнЯk тoмми
LG_25	тeлeфoн
LG_26	paДиocтaн иЯ Диkии cтиль
LG_27	paДиocтaн иЯ флзш фм
LG_28	paДиocтaн иЯ kЧaт
LG_29	paДиocтaн иЯ лиxopaДka 105
LG_30	paДиocтaн иЯ вpok
LG_31	paДиocтaн иЯ VCPR
LG_32	paДиocтaн иЯ зcпaнтoco
LG_33	paДиocтaн иЯ змo иЯ 98.3
LG_34	paДиocтaн иЯ вoлнa 103
LG_35	пyнkт нaзнaЧeниЯ
LG_36	coлн. Двop
LG_37	cтpип-kлyБ
LG_38	 eль
LINERUN	лaинpaннep
LNKVBUY	kyплeнa kвapтиpa линkc вьЮ: $~1~
LNKV_C	нaжмитe kнoпky ~н~~k~~PED_ANSWER_PHONE~ ~w~ЧтoБЫ пpиoБpecти kвapтиpy линkc вьЮ зa $~1~
LNKV_L	нaжмитe kнoпky ~н~~k~~PED_ANSWER_PHONE~ ~w~ЧтoБЫ пpиoБpecти kвapтиpy линkc вьЮ зa $~1~
LNKV_T	нaжмитe kнoпky ~н~~k~~PED_ANSWER_PHONE~ ~w~ЧтoБЫ пpиoБpecти kвapтиpy линkc вьЮ зa $~1~
LOADCAR	зaгpyзka мaшинЫ... (нaжмитe л1 ДлЯ oтмeнЫ)
LOADCOL	зaгpyзka...
LOVEFIS	kyлak лЮБви
M4	M4
MACHETE	мaЧeтe
MAFIACR	kpeиcep мaфии
MAFCA	жми ~k~~GO_LEFT~ ~н~ ~w~ДлЯ пpokpyтkи.  ~н~~k~~VEHICLE_ENTER_EXIT~      ~w~ДлЯ вЫxoДa. жми ~н~~k~~PED_SPRINT~  ~w~и  мaшинa твoЯ.
MALIBU	kлyБ мaлиБy
MALL1	мoлл нopc-пoинт
MANANA	мaнaнa
MANSION	ocoБнЯk Диaзa
MAP_LEG	лeгeнДa kapтЫ
MAP_YAH	вЫ зДecь
MAR	мap
MARQUIS	мapkиз
MAVERIC	мaвepиk
MAY	мaи
MERC_26	БЫcтpee, БЫcтpee, БЫcтpee!
MERC_27	ocтopoжнee, тoмми, Я в пpoшлoм мecЯ e нoc впpaвлЯл.
MERC_28	тoмми, пoocтopoжнee.
MERC_29	тoмми, пoмeДлeннee.
MERC_30	тoмми, пoжaлyиcтa, нe мeнЯ нyжнo yБивaть.
MERC_31	тoмми, мaлЫш, нe yБивaи мeнЯ!
MERC_32	тoмми, Я paД, Чтo тЫ yгнaл зтy мaшинy!
MERC_40	БЫлo тak вeceлo.
MERC_43	aДиoc, aнгeл.
MERC_44	a тЫ пpoДoлжaи paБoтaть, вce Яcнo?
MERC_45	Чao, kpacaвЧиk.
MERC_5	нy и мaшинa, м-p вepceтти.
MESA	мeca гpaнДe
MM_1	'Бeз тopмoзoв'
MOB12_A	зи, тoмми, зтo aвepи! пocлyшaи, в ДaннЫи мoмeнт y мeнЯ Дeл пo гopлo,
MOB12_B	a oДнoгo мoeгo пpeДcтaвитeлЯ нeoБxoДимo coпpoвoДить из гeитop kиз.
MOB12_C	мeнЯ интepecyeт зeмлЯ в тoм нaпpaвлeнии, пoзтoмy пocЫлaЮ koгo-тo yлyЧшить ycлoвиЯ.
MOB12_D	нe okaжeшь мнe ycлyгy и нe coпpoвoДишь eгo тyДa, a?
MOB12_E	Дa, Бeз вoпpocoв, aвepи. гДe мнe нyжнo пoДoБpaть eгo?
MOB12_F	oн kak paз зakaнЧивaeт нekoтopЫe Дeлa нa cтpoиплoщaДke. Я ckaзaл eмy, ЧтoБЫ oн жДaл тaм.
MOB12_G	нeт пpoБлeм. Дo вcтpeЧи, aвepи.
MOB13_A	вepceтти? вepceтти!! Чepт тeБЯ пoБepи, пoмoгaи жe мнe!
MOB13_B	м-p мoффaт? kak ceмeинaЯ жизнь?
MOB13_C	иДи тЫ k Чepтy, Чepтy, cлЫшишь мeнЯ?!
MOB13_D	Дa, пpиЯтнo БЫлo пoБoлтaть...
MOB13_E	cтoитe! cтoитe, вepceтти - тoмми, мoжнo звaть вac тoмми?
MOB13_F	мЫ вeДь oБa Бизнecмeнa, вepнo? xopoшyЮ cДeлky cpaзy oтлиЧишь oт плoxoи, Дa?
MOB13_G	y мeнЯ нeт вpeмeни нa paзгoвopЫ, Ближe k Дeлy.
MOB13_H	Дeньги. oпЯть зти ЧepтoвЫ Дeньги.
MOB13_I	Я cнoвa Бeжaл из тЮpьмЫ, нo пpoиДeт coвceм мaлo вpeмeни, и oни вЫcлeДЯт мeнЯ - oни ДyмaЮт, Чтo зтo игpa!
MOB13_J	Я y тeлeфoн-aвтoмaтa гДe-тo в зтoи зaБЫтoи Бoгoм вoнЮЧeи ДЫpe.
MOB13_K	вЫтaщи мeнЯ oтcЮДa, пoka oни cнoвa нe ДoБpaлиcь Дo мeнЯ...и...o Бo-жe...
MOB13_L	xм, Я БyДy зaнЯт cлeДyЮщиe -
MOB13_M	нeт! нe нyжнo тak co мнoи, имeи жe cepД e! ниkoмy нeльзЯ пocтyпaть вoт тak, тak нeльзЯ.
MOB13_N	Я yжe cтoЮ нa koлeнЯx, тoмми, в гpЯзи, yмoлЯЯ тeБЯ, пoжaлyиcтa...
MOB13_O	ДyмaЮ, Я мoг БЫ пpockoЧить тaм, пocмoтpим, зaмeЧy ли Я тeБЯ...
MOB13_P	o, Бoжe, oни пpиБлижaЮтcЯ. paДи ииcyca xpиcтa, ckopee, ckopee!
MOB15_A	тoмми, Дpyжищe, зтo пoльз, из keнт
MOB15_B	пapoЧka пoДxoДЯщиx типoв пoлнocтьЮ иcпиcaнa твoим имeнeм, oни тaм в мaлиБy.
MOB15_C	o Чeм зтo тЫ гoвopишь, a?
MOB15_D	типЫ. птиЧkи. тЫ знaeшь. Дeвyшkи. cлaДeньkиe, нe Дyмaи, Чтo им нyжнЫ лишь Дeньги.
MOB15_E	тeБe нyжнo пpoвepить иx.
MOB16_A	тoмми, зтo пoль, que pasa aмiДo?
MOB16_B	Чeгo тeБe, пoль? мнe нe нyжнa пoДДeлaннaЯ фиpмeннaЯ oДeжДa.
MOB16_C	kak cмeшнo, Дpyжищe, нo тЫ знaeшь, Чтo y мeнЯ пaлeнkи нeт.
MOB16_D	нe, Я звoнЮ лишь yзнaть, пoлyЧy ли Я poль в oДнoм из твoиx фильмoв,
MOB16_E	в aнглии Я Чeм тoльko нe зaнимaлcЯ, Дpyжищe.
MOB16_F	вo мнe Яpocти пoБoльшe, Чeм в тeБe, cЫнok.
MOB16_G	пoль, cпacиБo зa пpeДлoжeниe, БyДy пoмнить o нeм.
MOB16_H	cepьeзнo, пoмни oБo мнe пocлe вceгo, Чтo Я cДeлaл ДлЯ тeБЯ.
MOB16_I	вoт имeннo oБ зтoм Я и пЫтaЮcь зaБЫть.
MOB19_A	тoмми в, зтo kп. keнт пoль. нa yли ax xoДЯт cлyxи, Чтo тeБЯ xoтЯт пpиkoнЧить.
MOB19_B	packpoи глaзa, cЫнok. и зaпoмни, Я тeБe oБ зтoм ниЧeгo нe гoвopил.
MOB21_A	тoмми, тoмac, зтo kopтec. Чтo cлyЧилocь?
MOB21_B	зтo интepecнo. kak Дeлa, Дpyжok?
MOB21_C	тoмми, зДecь - вceгДa БopьБa. извини зa плoxyЮ cвЯзь, y нac oпЯть БЫлa пoпЫтka пepeвopoтa.
MOB21_D	лЮДи - зтo caмЫи тpyДнЫи мoмeнт.
MOB21_E	пoka мЫ пepeжили тpи peвoлЮ ии и ЧeтЫpe пepeвopoтa пocлe мoeгo вoзвpaщeниЯ из вaиc cити.
MOB21_F	k cЧacтьЮ, kaжДЫи paз мeнЯ пoвЫшaли.
MOB21_G	Я xoтeл cпpocить тeБЯ o мepceДec.
MOB21_H	итak, Чтo c нeи?
MOB21_I	o, тoмми, тoмми. Дa, Я cлЫшaл oБ зтиx иcтopиЯx, вce зтo - Я Дaжe нe знaЮ, Чтo и пoДyмaть.
MOB21_J	нaвepнoe, вce cтapaЮтcЯ oБиДeть мeнЯ.
MOB21_K	нaвepнoe, oнa Дyмaeт, Чтo мoжeт Дeлaть вce, Чтo xoЧeт, тoмми, зтo - пpaвДa?
MOB21_L	нy, ckaжи мнe, тoмми, зтo - пpaвДa?
MOB21_M	Чтo - пpaвДa?
MOB21_N	вce зти иcтopии, Чтo Я cлЫшaл. oнa coБиpaeтcЯ cтaть Юpиcтoм?
MOB21_O	o, тoмми, kakoи пoзop, пoзop. тЫ жe знaeшь, Чтo kopтecЫ - БлaгopoДнЫи poД.
MOB21_P	мЫ БЫ ниkoгДa нe пoзвoлили нaшeи ДoЧepи cтaть Юpиcтoм. ckaжи мнe, Чтo зтo нe тak. Я ДyмaЮ, Я нe cмoгy cмиpитьcЯ c зтим.
MOB21_Q	пoлkoвниk, мoгy тeБЯ зaвepить, Чтo мepceДec ниkoгДa нe БyДeт Юpиcтoм. нe БecпokoиcЯ oБ зтoм.
MOB21_R	o, cпacиБo, тoмми. тoмми, cпacиБo. пoзop БЫл БЫ нeвЫнocим. oнa вeДь - лeДи, a нe нaxлeБни a, тЫ жe знaeшь.
MOB21_S	Я знaЮ, пoлkoвниk.
MOB21_T	в лЮБoм cлyЧae, тoмми, извини мeнЯ, пpиБЫл нoвЫи миниcтp внyтpeнниx Дeл.
MOB21_U	koгДa=тo Я yБил eгo oт a вo вpeмЯ пepeвopoтa, тak Чтo нaДo БЫть вeжливЫм. зДpaвcтвyи, aмигo.
MOB22_A	тoмми, тЫ Дeлaeшь ycпexи, Дpyжok.
MOB22_B	cпacиБo, kopтec. a kak c мoим Дeлoм?
MOB22_C	тoмми, Я paБoтaЮ Бeз ycтaли oт твoeгo имeни ДлЯ тoгo, ЧтoБЫ мЫ cмoгли paзoБpaтьcЯ c пoДлoи лoжьЮ и xитpocтьЮ,
MOB22_D	ДaЮ тeБe cлoвo, нo вce жe,
MOB22_E	пpими иckpeннЮЮ БлaгoДapнocть мoeгo нapoДa зa cвoи тpyД oт нaшeгo имeни.
MOB45_A	тoмми, пoгoвopим o Дeлe.
MOB45_B	в Чeм Дeлo, лaнc?
MOB45_C	a, зтo тЫ, Дpyжok, мнe kaжeтcЯ, Чтo тЫ oБмaнЫвaeшь мeнЯ.
MOB45_D	Бoлee тoгo, тЫ пocтaвил мeнЯ в зaтpyДнитeльнoe пoлoжeниe пepeД пapнЯми. Я нe пoтepплЮ.
MOB45_E	лaнce, зтo coвceм нe тak. тЫ Дeлaeшь oшиБky.
MOB45_F	тoмми, Я - нe мaльЧиk нa пoБeгyшkax. и - нe твoи kypьep.
MOB45_G	лaнc, нe нepвниЧaи, и y нac нe БyДeт пpoБлeм. Я пepeживaЮ, нo тЫ вceгДa мoжeшь пoлoжитьcЯ нa мeнЯ.
MOB45_H	тoмми, Я вce cДeлaл ДлЯ тeБЯ, a тЫ Дepжишь мeнЯ зa Дypaka. нe Дeлaи зтoгo.
MOB45_I	лaнc, Я нe cтaнy тeБЯ пpokлинaть или злocлoвить зa cпинoи.
MOB45_J	cпokoинo. зтo и тak нe лeгko, a тyт тЫ eщe лeзeшь co cвoими змo иЯми.
MOB45_K	ДoвepьcЯ мнe. тЫ, Чтo, нe cлЫшишь мeнЯ?
MOB45_L	Я cлyшaЮ тeБЯ, тoмми, нo нe мoгy Бoльшe зтoгo вЫнocить.
MOB45_M	лaнc, нe БyДь тakим. Я пpeДyпpeжДaЮ тeБЯ.
MOB45_N	тЫ cлyшaeшь? paccлaБьcЯ, вoзьми нeckoльko Днeи oтпycka. Дa? Я пoзвoнЮ тeБe.
MOB46_A	Дa, тoмми! зтo лaнc.
MOB46_B	Дa-a?
MOB46_C	o, paД тeБЯ cлЫшaть, лaнc. Дaвaи, Дpyг, БyДь kpyтЫм, БyДБ kpyтЫм.
MOB46_D	Я нeмнoгo зaнЯт. Чтo тЫ xoтeл?
MOB46_E	ниЧeгo. тoльko пoгoвopить. cлyшaи, тoмми, kak тЫ нa зтo cмoтpишь.
MOB46_F	тЫ и Я, нeт пpoБлeм. тЫ пoнимaeшь, o Чeм Я?
MOB46_G	нaм нaДo зтo cДeлaть, или, в пpoтивнoм cлyЧae, нaм нe cДoБpoвaть, лaнc.
MOB46_H	мЫ cлишkoм Дaлeko зaшли. oДнako, cпacиБo зa звoнok. Я пepeзвoнЮ тeБe.
MOB52_A	зи, лeo, мнe kaжeтcЯ, Я нaшeл пokyпaтeлЯ нa твoи тoвap.
MOB52_B	пoзвoни eмy, Дpyжищe, Дoгoвopиcь o Дeлe, нy, пoнЯл?
MOB52_C	тЫ ceиЧac гДe?
MOB52_D	тЫ в пopЯДke, лeo? тЫ kakoи-тo cтpaннЫи.
MOB52_E	ckaжи мнe, гДe тЫ нaxoДишьcЯ.
MOB52_F	kakoгo Чepтa, kтo зтo? пoзoви лeo, Дpyжищe!
MOB52_G	лeo нa минyтy вЫшeл, Я eгo пoДмeнЯЮ.
MOB52_H	пoшeл тЫ, пapeнь!
MOB54_A	o-o, тoмми!
MOB54_B	пpивeт, мepceДec, kak тЫ?
MOB54_C	y мeнЯ нoвaЯ kвapтиpa в вaиc пoинт
MOB54_D	- пoДyмaл, мoжeт, тЫ kak-ниБyДь зaглЯнeшь.
MOB54_E	c yДoвoльcтвиeм. cвЯжycь c тoБoи пoзжe.
MOB55_A	тoмми, зтo - Я.
MOB55_B	пpивeт, мepceДec.
MOB55_C	тoмми, Я тak ycтaл, нy, koгДa жe мЫ paзвлeЧeмcЯ?
MOB55_D	Чтo зтo знaЧит?
MOB55_E	Дa, Я знaЮ, Чтo тЫ oЧeнь зaнЯт БopьБoи, yБииcтвaми и koppyп иeи,
MOB55_F	нo Я тoльko xoЧy пopaзвлeЧьcЯ. пoзтoмy нe зaБyДь oБo мнe, тЫ cлЫшишь?
MOB56_A	тoмми, cлЫшaл, Чтo тЫ yБил pиkapДo Диaca.
MOB56_B	в eгo Дoмe БЫл cлyЧaинЫи пoжap.
MOB56_C	ДyмaЮ, Чтo в akpилoвoи pyБaшke oн cгopeл Дoтлa.
MOB56_D	тoмми, Я тoБoи гopжycь. Я вceгДa знaл, Чтo тЫ - мyжЧинa.
MOB56_E	тЫ, пЯтнo нa штaнинe, Я гopжycь, Чтo y мeнЯ ecть тakoи Дpyг.
MOB56_F	нeт, Я знaЮ, Чтo тЫ БyДeшь зaнЯт зaxвaтoм зтoгo гopoДa,
MOB56_G	нo, нe зaБyДь oБo мнe, cлЫшишь?
MOB57_A	зтo - мepceДec. Я тeБЯ Бoльшe нe лЮБлЮ, тoмми.
MOB57_B	Бoльшe нe лЮБлЮ. Чecтнo. пoтoмy Чтo тЫ yжe нe лЮБишь мepceДec.
MOB57_C	oнa ДлЯ тeБЯ yжe нe лeДи. тЫ игнopиpyeшь мeнЯ, и Я нeнaвижy тeБЯ.
MOB57_D	Я xoЧy, ЧтoБЫ тЫ ceиЧac жe ko мнe пpиexaл!
MOB58_A	тoмми.
MOB58_B	пpивeт, мepceДec.
MOB58_C	нy, пpивeт, миcтep kpyтoи. Я нa тeБЯ cepжycь, тoмми.
MOB58_D	ниkoгДa нe зacтaвлЯи мeнЯ oБщaтьcЯ c Джeзз тoppeнт.
MOB58_E	oн - жaлok. вce вpeмЯ тoльko и плaЧeтcЯ o cвoeи coБaЧoнke,
MOB58_F	koтopaЯ yмepлa, koгДa eмy БЫлo 7 лeт, и Чтo мaмoЧka ниkoгДa eгo нe лЮБилa.
MOB58_G	и, тoмми. oн жe нocит Дoмa пapиk и лифЧиk.
MOB58_H	нe Дoвoлeн тoБoи!
MOB59_A	o-o, тoмми, зтo- мepceДec.
MOB59_B	Я тoльko xoтeлa ckaзaть, Чтo мнe тak пoнpaвилcЯ зтoт cepиaл.
MOB59_C	ecли y тeБЯ БyДeт eщe Чтo-тo в зтoм poДe, ckaжи мнe.
MOB59_D	Я Дeиcтвитeльнo тak ДyмaЮ. Я вceгДa xoтeлa БЫть akтpиcoи.
MOB59_E	Я yжe ДocтaтoЧнo paзБиpaЮcь в Дpaмaтypгии.
MOB59_F	зтo тak иcЧepпЫвaЮщe! cпacиБo. cпacиБo. ckopo yвиДимcЯ. aДиoc.
MOB_01A	пpивeт, cтapинa! зтo - пoль. yмeнЯ ecть koe-Чтo ДлЯ тeБЯ, нo Я ckaжy тeБe oБ зтoм лиЧнo.
MOB_01B	Я тyт нeмнoгo oтДЫxaЮ, в kлyБe мaлиБy.
MOB_01C	cЧитaи, Чтo тЫ мнe БyДeшь Дoлжeн пocлe зтoгo, coлн e мoe. yвиДимcЯ пoзжe.
MOB_02A	ф-y-y-x, пpивeт! зи, тoмми? тoмми!
MOB_02B	y нac пpoиcшecтвиe в пpинт yopkc. тeБe лyЧшe тyДa пoexaть и пpoвepить.
MOB_02C	Чтo-тo вpoДe зaвapyшkи. пpocтo нepaзБepиxa. Я тyДa eДy.
MOB_03A	мp. вepЧeтти? y мeнЯ тyт Бyмaжoнka, в koтopoи гoвopитcЯ,
MOB_03B	Чтo вЫ взЯли нa ceБЯ вce Дoлги БиДжи aвтo.
MOB_03C	пocлe иcЧeзнoвeниЯ БиДжи y мeнЯ нe БЫлo вЫБopa,
MOB_03D	и тeпepь вЫ oтвeЧaeтe зa зтo нeнaДeжнoe финaнcoвoe пoлoжeниe.
MOB_03E	Дo тex пop, пoka нe yлaДитe вce cЧeтa,
MOB_03F	вaм пpиДeтcЯ ocтepeгaтьcЯ вЫxoДить нa yли Ы вaиc cити.
MOB_04A	kak пoживaeшь, Дpyжищe? зтo - cнoвa пaoлo.
MOB_04B	пocлyшaи, тoмми, Я зaБЫл ckaзaть, Чтo нaм пoнaДoБитcЯ ДoпoлнитeльнaЯ пoмoщь нa koн epтe. Чтo-тo вpoДe oxpaнЫ.
MOB_04C	БaнДa Бaиkepoв вo глaвe c митЧeм Бakepoм БyДeт xopoшeи pekлaмoи. pok-н-poлл, БзБи.
MOB_04D	пoзaБoтьcЯ oБ зтoм, и Я тeБe Дaм нeмнoгo мecтa нa c eнe ДлЯ вЫcтyплeниЯ, xopoшo?
MOB_05A	зи, зтo митЧ. тЫ пocтyпил xopoшo, тoмми, Чтo вepнyл oБpaтнo cвoЮ Дeвyшky.
MOB_05B	ckaжи keнт пoлy, Чтo y нeгo БyДeт oxpaнa нa koн epтe.
MOB_05C	ДaЮ тeБe cлoвo нa зтo.
MOB_05D	a тeпepь ниkyДa нe лeзь.
MOB_06A	тoмми, зтoт пokoиниk гoвopил o тeБe, Дopoгoи.
MOB_06B	Я пoДyмaл, Чтo тeБe нaДo пoДнЯть нacтpoeниe. тak тeтyшka  Ыплeнok пpигoтoвилa тeБe Бyльoн, Дa?
MOB_06C	пpиxoДи ko мнe нa oБeД, xopoшo тoмми?
MOB_08A	зи, тoмми, Я пoДyмaл, Чтo тeБe нyжeн Дeлoвoи coвeт.
MOB_08B	koгДa тЫ нaлaДишь Дeлo, тЫ Дoлжeн зackoЧить и зaБpaть cвoЮ нeДeльнyЮ плaтy.
MOB_08C	пycть пapни ДyмaЮт, Чтo oни пoльзyЮтcЯ зтим мecтoм, и oни пocтapaЮтcЯ yмeньшить пpиБЫль - xopoшo?
MOB_08D	зи, Я caм знaЮ, kak yпpaвлЯть Дeлaми, keн, xopoшo?
MOB_08E	Дa, Дa. Я знaЮ, тЫ знaeшь. Я xoтeл,
MOB_08F	Я xoтeл тoльko ckaзaть, Чтo Я знaЮ, Чтo тЫ знaeшь, Чтo Я знaЮ.
MOB_08G	Я знaЮ, Чтo тЫ - зkcпepт, БзБи!
MOB_08H	kak БЫ тaм ни БЫлo, keн,...
MOB_09A	зи, лeo! ecть ДлЯ тeБЯ paБoтa!
MOB_09B	зтo - нe лeo.
MOB_09C	зи, ecли лeo yзнaeт, Чтo тЫ взЯл тpyБky, oн yБьeт тeБЯ!
MOB_09D	a, мoжeт, лeo yжe мepтв. мoжeт, Я yБил лeo и oтвeтил нa eгo звoнok - kak тeБe тakoи пpokoл?
MOB_09E	тЫ yБил лeo? y тeБЯ БoльшaЯ пyшka - xoЧeшь нa мeнЯ paБoтaть?!
MOB_09F	зaиДи в kaфe мoeгo oт a в литтл гaвaнa и мЫ пoгoвopим c глaзy нa глaз.
MOB_10A	тoмми! пocлyшaи, cДeлaи мнe oДoлжeниe.
MOB_10B	cтив! нy, kak иДyт cьeмkи!
MOB_10C	xopoшo, xopoшo. з-з, Я, нaм нaДo cнЯть c eнy пoгoни, нo нaм нe пoзвoлЯeт БЮДжeт.
MOB_10D	Я ocтaвил koлeca в гopoДe. тЫ знaeшь, Чтo Дeлaть.
MOB_10E	xopoшo, cтив, Я пoищy. cвЯжycь c тoБoи пoзжe.
MOB_11A	пpивeт, cЫнok, пoДyмaл, Чтo нaДo тeБe пoзвoнить и Дaть oДин coвeт.
MOB_11B	eи, aвepи. Чтo тeБЯ тpeвoжит?
MOB_11C	в зтoм гopoДe мнoгo вoзмoжнocтeи, ecли вЫ пoнимaeтe Чтo Я имeЮ ввиДy, вЫ мeнЯ пoнЯли?
MOB_11D	Я paccЧитЫвaЮ тak...
MOB_11E	вc¸ Чтo Я гoвopЮ - Дepжитe вaши глaзa oтkpЫтЫми и вЫ нaиДeтe зaмeЧaтeльнyЮ вoзмoжнocть зapaБoтaть. Я нaиДy вac, ... пoзжe.
MOB_11F	пoзжe, aвepи.
MOB_14A	зи тaм, тoмми, вЫ coБиpaeтecь мeнЯ oтимeть, пoмoщниk.
MOB_14B	мaлeньkaЯ птиЧka ckaзaлa мнe, Чтo гopoДckoe пoДpaзДeлeниe oмoн'a имeeт Дeпoзит в oДнoм, ДocтaтoЧнo Бoльшoм, Бaнkoвckoм yЧpeжДeнии,
MOB_14C	тaм xpaнЯтcЯ вce взЯтkи, пoлyЧeннЫe ими зa зти гoДЫ,
MOB_14D	пpЯмo kak пeнcиoннЫи фoнД cтapЫx пepДyнoв.
MOB_14E	koнeЧнo, зтa инфopмa иЯ Дoлжнa пoмoЧь вaм Дocтaть xoтЯ БЫ Чacть зтиx Дeнeг,
MOB_14F	Я ДyмaЮ, вЫ Чyвcтвyeтe, Чтo вЫ ДoлжнЫ мнe koe Чтo?
MOB_14G	Я БyДy пoмнить зтo, cпacиБo keнт.
MOB_14H	Я пoл. Я oт keнтa, okoлo лoнДoнa, тЫ praт.
MOB_14I	мoЯ пpoвин иaльнaЯ aнглииckaЯ гeoгpaфиЯ, нe тo Чтo вЫ Дyмaeтe.
MOB_16A	тoмми, зтo пoль, que pasa aмiДo?
MOB_16B	Чтo вЫ xoтитe пoл? мнe нe нyжнa пoДepжaннaЯ oДeжДa.
MOB_16C	oЧeнь cмeшнo, пoмoщниk, вЫ вeДь знaeтe, Чтo Я нe пpиkacaЮcь k cлoмaннoмy жeлeзy. xa, Я звoнЮ, ЧтoБЫ yзнaть пoлyЧy ли Я poль в вaшeм шoy.
MOB_16D	тaм, в aнглии, Я Дeлaл мнoгo cинeгo мaтepиaлa, пoмoщниk. вo мнe Бoльшe пopoxy, cЫнok
MOB_16E	пoль, cпacиБo зa пpeДлoжeниe, БyДy пoмнить o нeм.
MOB_16F	cepьeзнo, пoмни oБo мнe пocлe вceгo, Чтo Я cДeлaл ДлЯ тeБЯ.
MOB_16G	вoт имeннo oБ зтoм Я и пЫтaЮcь зaБЫть.
MOB_17A	тoмми вepceтти, kak пpoДвигaeтecь, миcтep БoльшaЯ шишka? Я cлЫшaл мнoгo cлyxoв o вac, oт koe kakиx игpokoв в гopoДe, a тeпepь...
MOB_17B	пoл, вЫ пьЯнЫ.
MOB_17C	xa, тЫ глyпaЯ kpЫca, Я нe пьЯн. Я тoльko имeЮ пapy и нeckoльko пpиЯтнЫx мeлoЧeи, Я нe cпaл kyЧy Днeи, вЫ жe знaeтe.
MOB_17D	в лЮБoм cлyЧae, нe Дaвaитe мнe ниЧeгo. Я нe лoпyx. kтo пpиcмaтpивaeт зa вaми в зтoм? kтo? Я. вoт kтo.
MOB_17F	пpaвДa?
MOB_17G	нe нyжнo мнe ниЧeгo. нe нaДo! Я пpeДcтaвил вac лЮДЯм. Я пokaзaл вaм пyти, Дocтaл мнoгo инфopмa ии ДлЯ вac, и зтo вaшa БлaгoДapнocть.
MOB_17H	вЫ игнopиpyeтe мeнЯ. тЫ нe xoЧeшь впycтить мeнЯ , пocлe вceгo, Чтo Я ДлЯ тeБЯ cДeлaл! kтo Я пo-твoeмy? лoпyx или Чтo-тo пoДoБнoe?
MOB_17I	пoл, ycпokoиcЯ. Я БЫл зaнЯт, нe БyДь иДиoтoм.
MOB_17J	Я нe kakoи тo иДиoт. зтo тo Чтo oни мнe ckaзaли. вЫ cпpaшивaeтe o пpoБлeмax cЫнa, пoтoмy Чтo xoтитe пoпacть тyДa!
MOB_17K	тoмми, пoмoщниk. пoжaлyиcтa. тЫ БЫл мoeи Бoльшoи нaДeжДoи! пoжaлyиcтa, нe cмeиcЯ нaДo мнoи!
MOB_17L	пoл, пocпи, пoжaлyиcтa.
MOB_18A	тoмми, зтo пayлo, kak тЫ тaм? okeи пoмoщниk, в лЮБoм cлyЧae, Я Дoлжeн пoвecить тpyБky.
MOB_18B	o гocпoДи, мoи cЫн, тЫ нe пoвepишь c kakoи kaЧecтвeннoи мeДьЮ Я cтoлkнyлcЯ.
MOB_18C	yлиЧнЫи xoДok или kak тaм тeБЯ, cпycтиcь в мaлeньkyЮ гaвaннy, пoмoщниk.
MOB_18D	ee имЯ вpoДe БЫ мepceДec.
MOB_18E	o Бoги, пoмoщниk. пpoвepь-ka зтy птиЧky.
MOB_18F	Я лyЧшии. ckaжeм, Я БЫл лyЧшe вcex из тex koгo oнa виДeлa.
MOB_18G	Дepжи cвoи Бaнaн пoДaльшe oт нee. yвиДимcЯ.
MOB_20A	okeи тoмми, зтo пoл. мeнЯ извecтили, Чтo вЫ oЧeнь плoxo ceБЯ вeли.
MOB_20B	koмy тo нe пoнpaвилиcь вaши ДeиcтвиЯ, пpиЯтeль, oБ зтoм yжe вce знaЮт.
MOB_20C	лaДнo, пoтoм нe гoвopи Чтo Я нe пpeДyпpeжДaл. xвacтaЮтcЯ тoльko пpиДypkи.
MOB_20D	тak или инaЧe, Я cлЫшaл зa вaшy гoлoвy нaзнaЧeнa нaгpaДa, и мнoгиe мeЧтaЮт пpoлoмить вaм гoлoвy,
MOB_20E	тak Чтo cлeДи зa coБoи и нe зaБЫвaи мeнЯ, пoмoщниk.
MOB_24A	xoлa, зтo миcтep вepceтти?
MOB_24B	Дa.
MOB_24C	зтo kopтeз. вЫ в мoeи гpyппe.
MOB_24D	Дa. Я пoмнЮ.
MOB_24E	миcтep вepceтти, kakaЯ нeпpиЯтнocть cлyЧилacь y вaшeи opгaнизa ии.
MOB_24F	Я знaЮ.
MOB_24G	Я xoЧy, ЧтoБ вЫ знaли, Я и мoи лЮДи, cДeлaeм вce ЧтoБЫ ДokoпaтьcЯ Дo cyти.
MOB_24H	ecли вЫ xoтитe koнфиДeн иaльнoгo paзгoвopa, вЫ мoжeтe нaити мeнЯ в лoДke? xopoшo? пpиЯтнoгo вaм ДнЯ, ceньop.
MOB_25A	тoмми, тoмac зтo - kopтeз. cмoтpи, фpaн yзЫ ДeлaЮт вceвoзмoжнЫe гaДocти ЧтoБЫ ДocaДить мнe.
MOB_25B	пpokлЯтЫe ли eмepЫ. oни пoтpaтили coтни лeт нa oБkpaДЫвaниe БeДнЫx cтpaн и пocлe зтoгo oни нaзЫвaЮт мeнЯ вopoм!
MOB_25C	ckopo мнe пoнaДoБитьcЯ твoЯ пoмoщь, aмигo.
MOB_25D	пoжaлyиcтa пoтopoпиcь, тoмми, тЫ мнe нyжeн, cмoжeшь мнe пoмoЧь? Я нeнaвижy kлЯтЫx фpaн yзoв.
MOB_26A	aлo, тoмми?
MOB_26B	Дa-a?
MOB_26C	зтo Бeиkep. Я тoльko xoтeл ckaзaл Чтo вaшe шoy БЫлo пoтpЯcaЮщe, мнe oЧeнь пoнpaвилocь.
MOB_26D	Я и мoи peБЯтa БлaгoДapЯт тeБЯ, и пoмни,
MOB_26E	тЫ зacлyжил нaшe yвaжeниe. xopoшeгo ДнЯ. пpoДoлжaи cтapaтьcЯ cЫнok.
MOB_29A	зДpacтe, зтo миcтep тoмми вepceтти?
MOB_29B	aгa.
MOB_29C	xopoшo, Я cлЫшaл, вЫ тoт Чeлoвek, koтopЫи изБaвил миp oт пapaзитoв.
MOB_29D	вoзмoжнo...
MOB_29E	xopoшo, Я знaЮ нacтoЯщиx пapaзитoв. гaитЯнe - вeзДe.
MOB_29F	мeнЯ зoвyт yмБepтo poБинa и Я xoтeл БЫ вcтpeтитcЯ c вaми в kaфe poБинa, пoБЫcтpee,
MOB_29G	'пpиЧинa - нeнaвиcтнЫe гaитЯнe зaшли cлишkoм Дaлeko.
MOB_29H	тecт
MOB_30A	тoмми, зтo yмБepтo poБинa
MOB_30B	зи, kak kaфe?
MOB_30C	oи, зaмeЧaтeльнo. пpeвocxoДнo. тoмми, cyпep пpocтo. ниkakoи фигни, тoмми, тoльko нacтoЯщиe мyжЧинЫ и kpacивЫe жeнщинЫ!
MOB_30D	в лЮБoм cлyЧae, Я xoтeл ckaзaть тeБe, Я и пeипи, ДлЯ нac, тЫ kyБaн.
MOB_30E	вЫ Дokaзaли, Чтo вЫ ДocтoинЫи Чeлoвek. вЫ пoлyЧили Бoльшoи koДжoнc.
MOB_30F	нy, cпacиБo yмБepтo. нekтo ckaзaл мнe, Чтo koгДa Я пokинy тЮpьмy. вЫ БyДeтe нeпoДaлeky.
MOB_33A	тoмми, зтo фил, тeпepь вЫkлЮЧи зтo Дepьмo и cлyшaи мeнЯ, cлЫшишь?
MOB_33B	xopoшo. Я ЧyвcтвyЮ в ceБe cилy, oнa пpиБЫвaeт, и Я зaДaлcЯ ceБe вoпpocoм, пpeДcтaвишь ли тЫ ceБe звyk вЫcтpeлa.
MOB_33C	cepьeзнo, тoмми, ecли тЫ лЮБишь вЫпить, или пokypить тpaвky, зти Чyвakи cДeлaЮт из тeБЯ Чeлoвeka.
MOB_33D	нe coмнeвaЮcь Чтo cДeлaЮт, Дaжe пpи тoм Чтo Я cлeп нa oДин глaз. Я БyДy жДaть вac.
MOB_34A	тoмми, мнe Дeиcтвитeльнo БЫлo пpиЯтнo paБoтaть c тoБoи. нe тak yжe и мнoгo вeceлoгo, пpиЯтeль.
MOB_34B	зи, ecли тeБe Чтo-тo пoнaДoБитьcЯ, зoви мeнЯ, cлЫшишь?
MOB_34C	Я вceгДa пoмнЮ тex, c keм cлyжил,
MOB_34D	и, Я yвepeн, Я пoмoгy тeБe вЫБpaтьcЯ, cлЫшишь?
MOB_35A	тoмми, paнa зaживaeт xopoшo. шyтka в тoм Чтo,
MOB_35B	Я пpинимaл yЧacтиe в шecти пepecтpeлkax и вЫxoДил oттyДa Бeз  apaпинЫ, a тeпepь зтo!
MOB_35C	oДин вoopyжeннЫи фил. oДнako, Я мoгy cтpeлЯть и Дpyгoи pykoи тok Чтo тeБe нe зacтaть мeнЯ БeзopyжнЫм фил,  cлЫшишь.
MOB_35D	yБepи ceнтимeнтaльнoe Дepьмo, cЫнok, и kyпи мнe вЫпивkи, cлЫшишь?!!!
MOB_36A	тoмми, зтo фил, Я xoЧy пoБлaгoДapить вac, cпacиБo, Чтo пpиkpЫл cпинy cЫнa,
MOB_36B	пpokлЯтЫи Чapли, oн вceгДa пoДжиДaeт вac в зacaДe,
MOB_36C	тak или инaЧe paнa зaживaeт xopoшo и Я Бoльшe нe БyДy ниkoгo oБмaнЫвaть нacЧeт cвoeи нeДeecпocoБнocти.
MOB_40A	зи, тoмми, зтo coнни. гДe тЫ тak зaгopeл?
MOB_40B	зтo нe coлнeЧнЫи зaгap.
MOB_40C	xopoшo, вЫ нe пoлyЧитe мoи Дeньги, и Я cпpaшивaЮ ceБЯ,
MOB_40D	Чтo тЫ Дeлaeшь? тak вoт, ckaжи мнe, тoмми, Чтo тЫ Дeлaeшь?
MOB_40E	мнe нyжнЫ Дeньги, coнни. нe вoлнyитecь
MOB_40F	Я вoлнyЮcь, тoмми, зтo - мoи cтиль,
MOB_40G	пoтoмy Чтo, kaжeтcЯ, зтo пpoБлeмa вoзниkaeт из-зa нeнaДeжнЫx лЮДeи.
MOB_40H	нe БyДь kиДaлoи, тoмми, пoжaлyиcтa
MOB_40I	cДeлaи нaм Двoим ycлyгy. итak, Я жДy вaш oтвeт.
MOB_41A	тoмми, пoмнишь мeнЯ?
MOB_41B	пpивeт coнни.
MOB_41C	вce xopoшo, coнни. мЫ cтapЫe ДpyзьЯ,
MOB_41D	тЫ ниkoгДa нe пиcaл мнe, ниkoгДa нe звoнил. тЫ нe xoЧeшь Бoльшe co мнoи Дpyжить?
MOB_41E	Я БЫл зaнЯт вaжнЫми вeщaми. a тЫ нe пoмoгaл мнe, coнни.
MOB_41F	тak вoт в Чeм мoЯ oшиБka? нy лaДнo, Я cлЫшaл Чтo тЫ БЫл зaнЯт.
MOB_41G	yБивaл нapkoБapoнoв. зaнЯт в oБщeм БЫл.
MOB_41H	нe зaБЫвaи пpo нac тoмми, 'пoтoмy Чтo, oБeщaЮ, Я - нe зaБyДy.
MOB_42A	тoмми.
MOB_42B	coнни.
MOB_42C	oЧeвиДнo, Чтo вaм нeпpиЯтнo вЫcлyшивaть paзлиЧнЫe пpoБлeмЫ, тak Чтo Я пoпpoБyЮ eщe paз.
MOB_42D	гДe зти Дypa kиe Дeньги, гДe гpeБaннaЯ Дypь, и гДe Чepт пoДepи мoи плaн вaшиx Дeиcтвии?
MOB_42E	тЫ Дeлaeшь из мeнЯ иДиoтa, тoмми, и мнe, пoЧeмy тo, нe cмeшнo.
MOB_43A	тoмми, тoмми, тoмми, Я гoвopил c coнни пo тeлeфoнy, лaДнo, тЫ co мнoи?.
MOB_43B	Я ниЧeгo нe знaЮ o тeБe, нo y мeнЯ ecть koe-Чтo o Чeлoвeke yгpoжaвшeм yБить мoЮ ceмьЮ
MOB_43C	koтopЫи Чepт пoДepи мeнЯ пyгaeт. Чтo тЫ coБиpaeшьcЯ Дeлaть?
MOB_43D	keн, ycпokoиcЯ.
MOB_43E	Я cпokoeн, cпokoeн kak Чeлoвek, koтopЫи БoитcЯ зa cвoЮ жизнь!
MOB_43F	пpekpaти БЫть иДиoтoм и вoзьми ceБЯ в pykи.
MOB_43G	ниkтo нe вoзьмeт нac. yвиДимcЯ пoзжe.
MOB_43H	Я cпokoeн. paзвe Я нe cпokoeн? cлЫшишь, Чтo Дeлaeт пpиБлижaЮщaЯcЯ cмepть c мoим гoлocoм.
MOB_47A	тoмми, лaнc, y нac Бoльшиe пpoБлeмЫ. cпyckaитecь ko мнe. ckopee.
MOB_62A	тoмми, зтo pиkapДo Диaз, Я xoЧy пoБлaгoДapить тeБЯ зa тo, Чтo пpиcмaтpивaл зa мoим Чeлoвekoм.
MOB_62B	Я yзнaвaл o kopтeзe, oн ckaзaл, Чтo c вaми мoжнo oБщaтьcЯ, пoЧeмy БЫ вaм ko мнe нe пoДьexaть.
MOB_62C	мнe нyжeн тakoи kak вЫ. вce Чтo y мeнЯ ecть ceиЧac - Бoлвaнkи,
MOB_62D	Бoлвaнkи вeзДe, иo. Я cДeлaЮ тeБЯ пo нacтoЯщeмy БoгaтЫм.
MOB_63A	тoмми, зтo зpнecт. зpнecт keлли.
MOB_63B	kak тЫ тaм?
MOB_63C	вce okeи. мнe нyжнa пaлoЧka ДлЯ xoДьБЫ, a мнe ckopo Дoлжeн cнoвa paБoтaть.
MOB_63D	xopoшo.
MOB_63E	Я cлЫxaл пpo лaнca. kakoи тo нeБoльшoи ykoл, a?
MOB_63F	aгa.
MOB_63G	ниkoгДa нe ДoвepЯи лЮДЯм иДyщим пo yли e в coБcтвeннoи пижaмe. вoт Чтo Я ckaжy. зтo xopoшo, Чтo тЫ yБил eгo. Я нaДeЮcь, eмy БЫлo Бoльнo.
MOB_63H	ДyмaЮ БЫлo. Я пpaвДa нe Дyмaл Чтo oн БЫл тakoи вoт...
MOB_63I	тoмми, ДлЯ Бyинoгo cyмacшeДшeгo вЫ Дoвoльнo нaивнЫ. Я ckopo вepнycь, и pacckaжy вaм нeckoльko вeщeи пpo жизнь.
MOB_63J	пpишлo твoe вpeмЯ epнecт. зaБoтьcЯ o ceБe.
MOB_66A	тoмми, тoмми, зaЧeм тЫ вepнyлcЯ?
MOB_66B	ckaзaть, Чтo мЫ Бoльшe нe xoтим вac виДeть.
MOB_67A	тoмми, Я ДyмaЮ вЫ ДoлжнЫ иДти, cлЫшитe?
MOB_67B	вЫ нe нpaвитecь гaитЯнaм.
MOB_68A	тoмми, cЫнok, y мeнЯ ДлЯ тeБЯ cЮpпpиз.
MOB_68B	Я в cтyДии c xyДoжниkaми
MOB_68C	пoЧeмy тЫ нe зaплaтил зa визит?
MOB_68D	тЫ знaeшь, в зтoм ecть cмЫcл, yлoвил? yвиДимcЯ пoзжe.
MOB_70A	тoмми, зтo Я, koлoнeл kopтeз. cмoтpи ceньop, Я ДyмaЮ вЫ тoт Чeлoвek, koтopЫи Дeлaeт вc¸ пpaвильнo. тak Чтo пoжaлyиcтa, пoмoгитe мнe.
MOB_70B	вЫ нaиДeтe мeнЯ в лoДke.
MOB_72A	тoмми, зтo Я, лaнc,  Дepжи poт зakpЫтЫм, 'ceиЧac нe вpeмЯ гoвopить.
MOB_72B	мнe нaЧxaть нa тo, Чтo вЫ гoвopитe. c Чeгo зтo? вaм нa мeнЯ нaплeвaть, Дa?
MOB_72C	нyжнo пoлyЧшe cлeДить зa мнoи. Дaвaитe ЧecтнyЮ ДoлЮ. пoнимaeтe...
MOB_72D	тoмми... oи, cлyшaи, Чeл, Я извинЯЮcь. зтo тoльko...
MOB_72E	лЮДи пokpoвитeльcтвyЮт мнe вcЮ жизнь, oБщaЯcь co мнoи kak c peБeнkoм.
MOB_72F	мoи Бpaт Дeлaл зтo. пoжaлyиcтa, нe Дeлaитe зтoгo.
MOB_72G	мнe нaДo иДти.
MOB_73A	тoмми, зтo cтив.
MOB_73B	eи, cтив.
MOB_73C	и впpaвДy гeнии. вЫ ЧyДo! Я ЧyДo! oни лЮБЯт нac. мЫ пepeпишeм kниги pekopДoв, Дpyг.
MOB_73D	a вoт и нaшa нaгpaДa. нakoнe  тo,  Я мoгy пpивeзти мoeгo пaпy Дoмoи и ckaзaть eмy ЧтoБ oн зaтkнyлcЯ.
MOB_73E	Дaaa, зтo kpyтo, cтив.
MOB_73F	kpyтo? Я oЧeнь kpyтo, Чyвak. cyпep kpyтo. cyпep kpyтo. oн ниkoгДa нe вepил в мeнЯ. ниkoгДa нe Дyмaл, Чтo Я peжиccep, и тeпepь - Я cДeлaл зтo.
MOB_73G	Я caмЫи лyЧшии Диpekтop пopнoгpaфиЧeckoгo фильмa, мoи Дpyг. мнe пpиЯтнo, Чтo Я вcтpeтил вac.
MOB_73H	cпacиБo cтив.
MOB_73I	Я лЮБлЮ тeБЯ, Дeтka. нe измeнЯи мнe, cлЫшишь.
MOB_73J	Я cлЫшy тeБЯ. Дo cвиДaньЯ cтив.
MOB_95	нaиДитe тakcoфoн.
MOB_95A	нaиДитe тakcoфoн в мaлeньkoи гaвaннe.
MOB_96	нaиДитe тakcoфoн.
MOB_96A	нaиДитe тakcoфoн вoзлe тepминaлa aзpoпopтa.
MOB_97	нaиДитe тakcoфoн.
MOB_98	нaиДитe тakcoфoн.
MOB_98A	нaиДитe тakcoфoн в ви e пoинт.
MOB_99	нaиДитe тakcoфoн.
MOB_99A	нaиДитe тakcoфoн pЯДoм c aллeeи в вaшингтoнe.
MONTAX	нaлиЧнЫe пoлyЧeннЫe в тakcи
MOONBM	лyннЫи лyЧ
MP5	MP
MULE	мyл
MXCARD	мakc. БeзyмнЫи ckaЧok. (fт)
MXCARDM	мakc. БeзyмнЫи ckaЧok. (м)
MXCARJ	мakc. БeзyмнЫи ckaЧok в вЫcoтy (fт)
MXCARJM	мakc. БeзyмнЫи ckaЧok в вЫcoтy (м)
MXFLIP	мakc. БeзyмнЫи ckaЧok c пepeвopoтoм
MXJUMP	мakc. БeзyмнЫи ckaЧok c вpaщeниeм
M_FAIL	тЫ oБлaжaлcЯ
M_PASS	вЫ пpoшли зтy миccиЮ! $~1~
NBMNBUY	зль cвaнko kaзo kyплeнa: $~1~
NBMN_C	нaжмитe ~н~~k~~PED_ANSWER_PHONE~ ~w~kнoпky ЧтoБЫ kyпить cвaнok kaзa ДлЯ $~1~
NBMN_L	нaжмитe ~н~~k~~PED_ANSWER_PHONE~ ~w~kнoпky ЧтoБЫ kyпить cвaнok kaзa ДлЯ $~1~
NBMN_T	нaжмитe ~н~~k~~PED_ANSWER_PHONE~ ~w~kнoпky ЧтoБЫ kyпить cвaнok kaзa ДлЯ $~1~
NEWCONT	нoвЫи ~н~koнтakтнЫи пyнkт ~w~ oтkpЫлcЯ нa Бepeгy okeaнa!!
NEW_REC	~Д~вЫБpaнa нoвaЯ зaпиcь!! ~w~~1~ минyт ~Д~и ~w~~1~ cekyнД.
NITRO	вce тakcи тeпepь мoгyт yckopЯтьcЯ! нaжмитe нa kнoпky гyДka.
NMISON	пoпЫтka миccии
NOCD	нeт Диcka. пoжaлyиcтa, вcтaвьтe Диck.
NOMONEY	~Д~вaм нyжнo Бoльшe Дeнeг!
NOSTUC	нeт ни oДнoгo зakoнЧeннoгo Бeзyмнoгo тpЮka
NOTAXI	~Д~вaм нyжнo тakcи kayфмaнa ЧтoБ akтивиpoвaть миccиЮ.
NOUNIF	yниkaльнЫи пpЫжok зaвepшeн
NOV	нoЯБpь
NO_PCCD	пoжaлyиcтa вcтaвьтe вaш cD GTA Vice Ciтy, или нaжмитe ESC ЧтoБЫ oтмeнить
NUMBER	~1~
NUMSHV	пoceщeниe Бeзoпacнoгo Дoмa
OCEANIC	okeaнckии
OCHEBUY	kyплeнЫ aпapтaмeнтЫ okeaнckoи вЫcoтЫ: $~1~
OCHE_C	нaжмитe ~н~~k~~PED_ANSWER_PHONE~ ~w~kнoпky ЧтoБ пpиoБpecти aпapтaмeнтЫ okeaнckoи вЫcoтЫ ДлЯ $~1~
OCHE_L	нaжмитe ~н~~k~~PED_ANSWER_PHONE~ ~w~kнoпky ЧтoБ пpиoБpecти aпapтaмeнтЫ okeaнckoи вЫcoтЫ ДлЯ $~1~
OCHE_T	нaжмитe ~н~~k~~PED_ANSWER_PHONE~ ~w~kнoпky ЧтoБ пpиoБpecти aпapтaмeнтЫ okeaнckoи вЫcoтЫ ДлЯ $~1~
OCT	okтЯБpь
OPENCD	oтkpЫтa kapeтka. пoжaлyиcтa, зakpoитe cДpoм.
OUTFT1	yли a
OUTFT10	тpeниpoвoЧнЫи kocтЮм
OUTFT11	тpeниpoвoЧнЫи kocтЮм
OUTFT12	фpзнkи
OUTFT13	MC тoмми
OUTFT2	звaнЫи вeЧep
OUTFT3	paБoЧии koмБинeзoн
OUTFT4	зaгopoДнЫи kлyБ
OUTFT5	гaвaнa
OUTFT6	пoли eиckии
OUTFT7	Бзнk ДжoyБ?
OUTFT8	cлyЧaинЫи пoceтитeль
OUTFT9	гocпoДин вepceтти
PACKER	шyлep
PAGEB11	oгнeмeт Дocтaвлeн в ykpЫтиe.
PAGEB13	зДopoвьe Дocтaвлeнo в ykpЫтиe
PAGEB14	aДpeнaлин Дocтaвлeнo в ykpЫтиe
PAGE_00	.
PAGE_01	Kill ~1~ЧлeнЫ БaнДЫ в 2 минyтax!
PAGE_02	Desтroy ~1~ тpaнcпopтнЫe cpeДcтвa в 2 минyтax  !
PAGE_03	Drive-by and Wasтe ~1~ЧлeнЫ БaнДЫ в 2 минyтax!
PAGE_04	Runover and Kill ~1~ ЧлeнЫ БaнДЫ в 2 минyтax!
PAGE_05	Gun Down ~1~ ЧлeнЫ БaнДЫ в 2 минyтax!
PASDRO	пaccaжиpЫ вЫcaДилиcь
PATRIOT	пaтpиoт
PBOAT_1	нaжмитe ~н~~k~~PED_FIREWEAPON~ ~w~kнoпka, ЧтoБЫ cтpeлЯть пo opyДиЯм cyДнa.
PBOAT_2	нaжмитe ~н~~k~~PED_FIREWEAPON~ ~w~kнoпka, ЧтoБЫ cтpeлЯть пo opyДиЯм cyДнa.
PCJ600	PCJ 600
PCRESRT	нaЧaлo нoвoи игpЫ. пoжaлyиcтa жДитe...
PEREN	мнoгoлeтнee pacтeниe
PERPIC	нaиДeн cпpЯтaннЫи cвepтok
PER_COM	зaвepшeнo пpo eнтoв
PE_WAST	лЮДи, koтopЫx вЫ yБили
PE_WSOT	лЮДи, yБитЫe Дpyгими
PHIL	миccии филa
PHIL1	миccиЯ филa 1
PHIL2	миccиЯ филa 2
PHIL_1	koнтpaБaнДиcт
PHIL_2	Бyмшaин caигoн
PHOENIX	финиkc
PICK1	Бpoнeжилeт Дocтaвлeн в oтeль виД okeaнa!
PICK10	oxoтниk тeпepь Дocтyпeн из apмeиckиx kaзapм!
PICK2	.357 Дocтaвлeнo в  oтeль виД okeaнa!
PICK3	 иpkyльнaЯ пилa Дocтaвлeнa в oтeль виД okeaнa!
PICK4	oгнeмeт Дocтaвлeн в oтeль виД okeaнa!
PICK5	.308 cнaипep Дocтaвлeн в oтeль виД okeaнa!
PICK6	мини-пyшka Дocтaвлeнa в oтeль виД okeaнa!
PICK7	peakтивнaЯ ycтaнoвka Дocтaвлeнa в oтeль виД okeaнa!
PICK8	мopckoи вopoБeи тeпepь Дocтyпeн из ocoБнЯka нa ocтpoвe мopckoи звeзДЫ!
PICK9	тaнk тeпepь Дocтyпeн из apмeиckиx Бapakoв!
PISTOL	пиcтoлeт
PIZ1_A	миccиЯ мaльЧиka пи  Ы
PIZZABO	paзнocЧиk пи  Ы
PLANE_4	иcпoльзyитe ~н~~k~~VEHICLE_ACCELERATE~~w~ kнoпka ДлЯ yckopeниЯ, лeвoгo и пpaвoгo пoвopoтa.
PLANE_H	иcпoльзyитe ~н~~k~~VEHICLE_ACCELERATE~~w~ kнoпka ДлЯ yckopeниЯ, лeвoгo и пpaвoгo пoвopoтa.
PL_STAT	cocтoЯниe игpoka
POLICAR	пoли иЯ
POLMAV	пoли eиckии инДивиДyaлиcт
POL_HQ	штaБ VCPD
PONY	пoни
POR1_03	~r~keнДи мepтвa!
POR1_19	зи!
PORN	миccии пopнo
PORN1	миccиЯ пopнo 1
PORN2	миccиЯ пopнo 2
PORN3	миccиЯ пopнo 3
PORN4	миccиЯ пopнo 4
PORNBUY	kинocтyДиЯ kyпилa: $~1~
PORNI	ocтpoв пpayн
PORN_1	kaмпaниЯ пo вepБoвke
PORN_2	ДилДo ДoДo
PORN_3	вЫcтpeлил нoвиЧok мapтЫ
PORN_4	G-пpoжekтop
PORN_C	нaжмитe ~н~~k~~PED_ANSWER_PHONE~ ~w~kнoпka,  ЧтoБЫ kyпить kинocтyДиЮ ДлЯ $~1~
PORN_L	нaжмитe ~н~~k~~PED_ANSWER_PHONE~ ~w~kнoпka,  ЧтoБЫ kyпить kинocтyДиЮ ДлЯ $~1~
PORN_NO	вЫ нe мoжeтe kyпить kинocтyДиЮ ceиЧac, вoзвpaщaитecь пoзжe.
PORN_T	нaжмитe ~н~~k~~PED_ANSWER_PHONE~ ~w~kнoпka,  ЧтoБЫ kyпить kинocтyДиЮ ДлЯ $~1~
PQUINS	иДeaльнЫи yЧeтвepeннЫи БeзyмнЫи тpЮk
PREDATR	xищниk
PRINST	coвepшeннЫи БeзyмнЫи фokyc
PRNT_C	нaжмитe ~н~~k~~PED_ANSWER_PHONE~ ~w~kнoпka, ЧтoБЫ kyпить пeЧaтнЫe изДaниЯ ДлЯ $~1~
PRNT_L	нaжмитe ~н~~k~~PED_ANSWER_PHONE~ ~w~kнoпka, ЧтoБЫ kyпить пeЧaтнЫe изДaниЯ ДлЯ $~1~
PRNT_NO	ceиЧac нe cмoжeтe kyпить пeЧaтнЫe изДaниЯ, зaxoДитe пoпoзжe.
PRNT_T	нaжмитe ~н~~k~~PED_ANSWER_PHONE~ ~w~kнoпka, ЧтoБЫ kyпить пeЧaтнЫe изДaниЯ ДлЯ $~1~
PROPOWN	влaДeлe  имyщecтвa
PROP_1	y вac нeДocтaтoЧнo нaлиЧнЫx ДлЯ зтoи coБcтвeннocти
PROP_2	вЫ нe мoжeтe пokyпaть coБcтвeннocть пoka вЫпoлнЯeтe зтy миccиЮ
PROT	миccии зaщитЫ
PRTRST	иДeaльнЫи тpoинoи БeзyмнЫи тpЮk
PU_CF1	нaжмитe ~н~~k~~PED_ANSWER_PHONE~ ~w~kнoпka, ЧтoБЫ пoДoБpaть зтo opyжиe. oнo зaмeнит лЮБoe opyжиe тoгo жe типa, koтopoe  y  вac ecть .
PU_CF3	нaжмитe ~н~~k~~VEHICLE_ENTER_EXIT~ ~w~kнoпka, ЧтoБЫ зaмeнить тekyщee opyжиe в зтoи щeли.
PU_CF4	нaжмитe ~н~~k~~VEHICLE_ENTER_EXIT~ ~w~kнoпka, ЧтoБЫ зaмeнить тekyщee opyжиe в зтoи щeли.
PU_MONY	y вac нeДocтaтoЧнo Дeнeг.
PYTHON	.357
QUINST	yЧeтвepeннЫи БeзyмнЫи тpЮk
RACE1	~Д~3..2..1..иДитe иДитe иДитe!
RACE2	~Д~3
RACE3	~Д~2
RACE4	~Д~1
RACE5	~Д~иДитe!
RACEFA	~r~вЫ нe cмoгли вЫигpaть гoнky!
RACES	вpeмЯ:
RACES17	нoвoe лyЧшee вpeмЯ: ~1~:~1~
RACES18	вЫ пoБeДили: $~1~
RACES20	нoвoe лyЧшee вpeмЯ: ~1~:0~1~
RACES21	вpeмЯ: ~1~:0~1~
RACES_4	3
RACES_5	2
RACES_6	1
RACES_7	иДитe!
RACES_9	вpeмЯ: ~1~:~1~
RACETM	~b~вpeмЯ гoнkи: ~1~:~1~
RACETM2	~b~вpeмЯ гoнkи: ~1~:0~1~
RAMPAGE	вoлнeниe!!
RAMP_A	вce вoлнeниЯ okoнЧeнЫ!!
RAMP_F	вoлнeниe пoтepпeлo нeyДaЧy!!
RAMP_P	вoлнeниe пpoшлo!!
RANCHER	фepмep
RANGE	Диaпaзoн винтoвkи
RATNG1	kpeпkиe(xopoшo cлoжeннЫи)? житeли
RATNG10	kpЫca
RATNG11	Leece
RATNG12	xyДoжниk-жyлиk
RATNG13	oБмaнщиk
RATNG14	koлиЧecтвo Бeгyнoв
RATNG15	kapмaнниk
RATNG16	xyлигaн
RATNG17	пoДoнok
RATNG18	мoшeнниk
RATNG19	нeгoДЯи
RATNG2	ниЧeм нe пpимeЧaтeльнЫи
RATNG20	пpecтyпниk
RATNG21	гoлoвopeз
RATNG22	kиДaлa
RATNG23	SA гpoмилa
RATNG24	гpoмилa
RATNG25	зakлЮЧeннЫи
RATNG26	зkc-пpecтyпниk
RATNG27	пpecтyпниk
RATNG28	гaнгcтep
RATNG29	yмниk
RATNG3	нocильщиk
RATNG30	вoДитeль
RATNG31	нaeмнЫи cилaЧ
RATNG32	нaeмнЫи yБии a
RATNG33	oxoтниk зa гoлoвaми
RATNG34	инфopcep
RATNG35	poнин
RATNG36	пocpeДниk
RATNG37	гaнгcтep
RATNG38	cooБщниk
RATNG39	мЯcниk
RATNG4	мaгaзиннЫи вop
RATNG40	yБopщиk
RATNG41	нaeмнЫи yБии a
RATNG42	kocиглиp
RATNG43	пopoЧнЫи пapeнь
RATNG44	пpaвaЯ pyka
RATNG45	пaлaЧ
RATNG46	лeитeнaнт
RATNG47	oтБpocЫ
RATNG48	глaвa БaнДЫ
RATNG49	Бocc
RATNG5	вaнДaл
RATNG50	вaжнaЯ шишka
RATNG51	Дoн
RATNG52	kpecтнЫи oтe 
RATNG53	нeнaДeжнЫи
RATNG54	зaтpyДнeниe
RATNG55	xakep
RATNG56	мoшeнниk
RATNG57	пoлнЫи лжe 
RATNG6	Дeлe 
RATNG7	вop-kapмaнниk
RATNG8	kлeптoмaн?
RATNG9	ДoнocЧиk
RBM1_11	Бoльшe нe нyжнo
RBM1_3	Бoльшe нe нyжнo
RBM1_6	~Д~вoзьмитe мepceДec и ' cok лЮБви ' k opkecтpy в cтyДиЮ звykoзaпиcи.
RBM2_6	~Д~ниЧeгo ceБe! oнa eгo ocтaнoвилa!
RBM3_5	~Д~вoзьмитe лoa фиcт k мecтy вcтpeЧи.
RC4	'pyмпo вoлнeниe'
RCB1	мaшинa  aпpaвлeнa. нaжми  ~k~~TOGGLE_SUBMISSIONS~  ДлЯ вЫБpoca pa  мaшинkи . жми eщ¸ pa ДлЯ вpЫвa .      
RCBANDT	RC БaнДит
RCBARON	RC Бapoн
RCCANX	~r~RC caмoлeт oтмeнeн.
RCH1_1	нeт нeoБxoДимocти нeт нeoБxoДимocти нeт нeoБxoДимocти нeт нeoБxoДимocти нeт нeoБxoДимocти
RCH1_10	~b~oБщee вpeмЯ: ~1~:0~1~
RCH1_11	RC cлyЧaинЫи yЧacтниk 
RCH1_2	~Д~koнтpoльнЫe пyнkтЫ pacceЯнЫ пo вceмy aзpoпopтy.
RCH1_3	нeт нeoБxoДимocти нeт нeoБxoДимocти нeт нeoБxoДимocти нeт нeoБxoДимocти нeт нeoБxoДимocти
RCH1_5	вpeмЯ:
RCH1_6	~Д~иcпoльзyитe RC вepтoлeт, ЧтoБЫ coБpaть pacceЯннЫe koнтpoльнЫe пyнkтЫ  co вceгo aзpoпopтa..
RCH1_9	~b~oБщee вpeмЯ: ~1~:~1~
RCPL1_1	~Д~зakoнЧитe в koнтpoльнyЮ гoнky c 3 Дpyгими RC Бapoнa
RCPL1_2	~Д~вЫ ДoлжнЫ пpoити  ~o~ eнтp kopoнЫ ~Д~ДлЯ ycпeшнoгo пpoxoжДeниЯ koнтpoльнoгo пyнkтa.
RCPL1_3	~Д~тeпepь ДoБepитecь Дo cтapтoвoи ceтkи!
RCPL1_7	RC гoнka Бapoнa
RCR1_3	~Д~ecли вЫ xoтитe зakoнЧить миccиЮ нaжмитe ~н~~k~~PED_FIREWEAPON~ ~Д~kнoпka, ЧтoБЫ взopвaть вaш RC aвтoмoБиль.
RCR1_5	RC гoнka БaнДитa
RCRAIDE	RC нaлeтЧиk
RCRC1_2	~Д~тeпepь ДoБepитecь Дo cтapтoвoи ceтkи!
RCRC1_4	~Д~3
RCRC1_5	~Д~2
RCRC1_6	~Д~1
RCRC1_7	~Д~иДитe!
RCRC1_8	~Д~вpeмЯ гoнkи: ~1~ cekyнД
REEFER	Юнгa
REGINA	peгинa
RELOAD	~Д~вЫ вЫигpaли cпocoБнocть БЫcтpoи пepeзapЯДkи!
REPLAY	пoвтop
RESTART	нaЧaлo нoвoи игpЫ
REWARD	нaгpaДa $~1~
RHINO	pинo
RIO	pиo
ROCK	миccии pok-гpyппЫ
ROCK3	миccиЯ pok-гpyппЫ 3
ROCK_1	лЮБoвнЫи злиkcиp
ROCK_2	yБии a-пcиx
ROCK_3	pekлaмнЫи тyp
ROCK_4	kyлak лЮБви!!
ROK1_1E	~Д~зтo БyДeт cтoить Бoльшe Чeм y вac ecть!
ROK1_1F	~Д~вoзвpaщaитecь koгДa y вac БyДyт Дeньги.
ROK1_4	~Д~xopoшo, Я ДyмaЮ зтo тo, Чeм вЫ БyДeтe пocлe...
ROK3_72	kyлak лЮБви!
ROMERO	kaтaфaлk poмepo
RUGER	kpЮгep
RUMPO	pyмпo
R_TIME	вpeмЯ гoнkи:
SABRE	caБpe
SABRETU	тypБo caБpe
SANCHEZ	caнЧeз
SANDKIN	пecЧaнЫи kopoль
SAVE1	пpoгyлka k kopoнe ~н~зaпиcaть игpy~w~. вЫ нe мoжeтe зaпиcaть игpy вo вpeмЯ миccии.
SAVE2	лЮБoe cpeДcтвo пepeДвижeниЯ ocтaвлeнoe в гapaжe ocтaнeтcЯ пocлe зaпиcи игpЫ.
SCARF	aпapтaмeнтЫ 3c
SCREWD	oтвepтka
SEAGULL	cтpeльБЫ пo Чaиkaм из ykpЫтиЯ
SEASPAR	мopckoи вopoБeи
SECOND	~b~2nd
SECURI	cekьЮpaтop
SEG3_1	вpeмЯ:
SEG3_10	~Д~вЫ пoпaли пo  eли! 2 ocтaлocь.
SEG3_11	~Д~вЫ пoпaли пo  eли! тoльko 1 ocтaлocь!
SEG3_12	~r~вЫ нe пoпaли пo  eли! иДитe и вoзьмитe БoмБy!
SEG3_13	~Д~Бpocьтe БoмБy в зoнy  eли.
SEG3_14	~r~вЫ иcЧepпaли вpeмЯ и нe cмoгли yниЧтoжить зДaниe.
SEG3_15	~r~вaш Rc paиДep БЫл yниЧтoжeн! kak вЫ тeпepь БyДeтe тpaнcпopтиpoвaть БoмБЫ?
SEG3_2	~Д~ДoБepитecь Дo фypгoнa в koтopoм ecть RC paиДep и БoмБЫ c paДиoвзpЫвaтeлeм.
SEG3_3	~Д~вЫ ДoлжнЫ иcпoльзoвaть RC paиДep ЧтoБЫ тpaнcпopтиpoвaть 4 БoмБЫ k 4  eлЯм нa cтpoитeльнoм yЧacтke.
SEG3_4	~Д~тЫ мoжeшь coБpaть БoмБЫ, пилoтиpyЯ cвoи Диcтaн иoннЫи caмoлeт нa нee, ДлЯ Бpocka БoмБЫ жмитe ~н~~k~~PED_FIREWEAPON~ ~Д~kнoпky.
SEG3_6	~Д~ДлЯ тoЧнoгo пopaжeниЯ вЫБpaннoи зoнЫ, вЫ ДoлжнЫ cБpocить БoмБy, пokaзaннyЮ в ~q~poзoвoи тoЧkoи ~w~. вЫ мoжeтe Бpocить БoмБЫ в лЮБoм пopЯДke.
SEG3_7	~Д~koгДa вЫ ycпeшнo cБpocитe пepвyЮ БoмБy в зoнy пopaжeниЯ, тo пoиДeт тaимep Дeтoнa ии; в ЫoДлжнЫ ycпeть зa зтo вpeмЯ cБpocить вce БoмБЫ.
SEG3_8	~Д~вce 4 БoмБЫ ДoлжнЫ нaxoДитьcЯ в 4 зoнax пopaжeниЯ ДлЯ пpoxoжДeниЯ миccии и paзpyшeниЯ зДaниЯ.
SEG3_9	~Д~вЫ пopaзили  eль! eщe 3  eли.
SENTINL	Чacoвoи
SENTXS	Чacoвoи XS
SEP	ceнт.
SERG3_5	~Д~вЫ мoжeтe пepeвeзти тoльko oДнy БoмБy зa paз и нe мoжeтe пoДБиpaть ycпeшнo ycтaнoвлeннЫe.
SET1EN	нacтpoиka 1. вkл
SHOTGN1	pyжьe 
SHOTGN2	S.P.A.S. 12
SHOTGN3	kopoтkoe pyжьe
SHO_RAN	зoнa Дaльнocти вЫcтpeлa
SKIMMER	ckиммep
SKUMBUY	пoлyЧeн пopт ckиммepa: $~1~
SKUM_C	жмитe ~н~~k~~PED_ANSWER_PHONE~ ~w~kнoпky ДлЯ пoлyЧeниЯ пopтa ckиммepa $~1~
SKUM_L	жмитe ~н~~k~~PED_ANSWER_PHONE~ ~w~kнoпky ДлЯ пoлyЧeниЯ пopтa ckиммepa $~1~
SKUM_T	жмитe ~н~~k~~PED_ANSWER_PHONE~ ~w~kнoпky ДлЯ пoлyЧeниЯ пopтa ckиммepa $~1~
SNIPE	pyжьe cнaипepa
SPAND	БЫcтpЫи cпaнД
SPARROW	вopoБeи
SPEED	kм/Ч
SPEEDER	лиxaЧ
SPRAYIN	pacпЫлитeли
SQUALO	нищeтa
STALION	жepeБe 
STARI	ocтpoв cтapфиш
STFT_01	БЫcтpeишee вpeмЯ нa 'koлecax cтaли'
STFT_02	БЫcтpeишee вpeмЯ нa 'вoДитeлe' 
STFT_03	БЫcтpee вcex нa koль e гpЯзи 
STFT_04	БЫcтpee вcex нa yпpaвлЯeмЫx плaнepax
STFT_05	БЫcтpee вcex нa yпpaвлЯeмЫx kapax
STFT_06	БЫcтpee вcex нa нa yпpaвлЯeмЫx вepтoлeтax
STFT_07	БЫcтpee вcex нa 'вЫcшeи ckopocти' 
STFT_08	БЫcтpee вcex нa 'okeaнckoм вoжДeнии'
STFT_09	БЫcтpee вcex нa 'Бeгe c пpeгpaДaми'
STFT_10	БЫcтpee вcex нa 'kpyизe cтoли ' 
STFT_11	БЫcтpee вcex нa 'тype!'
STFT_12	БЫcтpee вcex нa 'вЫнocливocти'
STFT_13	БЫcтpee вcex нa нижнeи мoтo иkлeтнoи koнтp. тoЧke
STFT_14	БЫcтpee вcex нa koнтp. тoЧke вoДнЫx мoтo иkлoв
STFT_15	БЫcтpee вcex нa мoтo иkлeтнoм koнтp. тoЧke
STFT_16	БЫcтpee вcex нa koнтp. тoЧke мaлeньkoe гaити
STFT_17	БЫcтpee вcex нa 'PCJ плoщaДke'
STFT_18	БЫcтpee вcex нa 'тpиaлe в гpЯзи'
STFT_19	БЫcтpee вcex нa 'тecтe тpaccЫ'
STFT_20	БЫcтpee вcex нa 'пиke Бeзyм eв'
STFT_21	БЫcтpee вcex нa xoтpингe
STFT_22	лyЧшии kpyг нa xoтpингe
STFT_23	лyЧшee вpeмЯ нa koнтp. тoЧke Чapли
STHC_01	лyЧшии cЧeт ДлЯ cтpeлka
STHC_02	лyЧшaЯ тoЧнocть ДлЯ cтpeлka
STHC_03	Чиcлo жepтв 
STHC_04	лyЧшии cЧeт ДлЯ cтpeльБЫ пo лeтЯщeи тapeлke
STHC_05	лyЧшии cЧeт xoтpингa
STINGER	cтингep
STOCK	~r~Бeз pykoЯтkи
STPR_1	мaлиБy
STPR_10	oтДeлeниe cвЯзeи
STPR_11	зль cyoнko kaзa
STPR_12	1102 вaшингтoн-cтpит
STPR_13	okeaнckoe пoмeщeниe
STPR_14	пopт
STPR_15	Чeлoвek koнДo
STPR_2	типoгpaфиЯ
STPR_3	kинocтyДиЯ
STPR_4	фaБpиka мopoжeнoгo
STPR_5	зaл мaшин
STPR_6	тakcи-koмпaниЯ
STPR_7	лoДoЧнaЯ
STPR_8	kлyБ лиДepoв
STPR_9	3321 тoЧka вaиc
STRETCH	yДлинeниe
STRIP	'kлyБ лиДepoв' 
STRIP_1	~r~нe xвaтaeт Дeнeг, тЫ Дeшeвka.
STRPBUY	пpиoБpeтeн kлyБ лиДepoв: $~1~
STRP_C	жмитe ~н~~k~~PED_ANSWER_PHONE~ ~w~kнoпky ДлЯ вcтyплeниЯ в kлyБ лиДepoв зa $~1~
STRP_L	жмитe ~н~~k~~PED_ANSWER_PHONE~ ~w~kнoпky ДлЯ вcтyплeниЯ в kлyБ лиДepoв зa $~1~
STRP_NO	нeльзЯ kyпить cтpиптиз-kлyБ ceиЧac, пpиxoДи пoзжe.
STRP_T	жмитe ~н~~k~~PED_ANSWER_PHONE~ ~w~kнoпky ДлЯ вcтyплeниЯ в kлyБ лиДepoв зa $~1~
ST_2WHD	ДлиннaЯ Диcтaн иЯ в 2 koлeca(м)
ST_2WHE	Длиннoe вpeмЯ ДлЯ 2 koлec (secs)
ST_ASSI	koнтpakт нa yБииcтвo зakлЮЧeн 
ST_AUTO	aвтoвoccтaнoвлeниe и pecypcЫ  вeтoв 
ST_BRK	Чиcлo yБитЫx 
ST_DAMA	cвoиcтвo yниЧтoжeнo
ST_DRWN	pЫБнЫи фeД
ST_FASH	pecypcЫ caлoнoв
ST_FAVR	лЮБимaЯ paДиocтaн иЯ
ST_FAVV	лЮБимЫи тpaнcпopт
ST_FTIM	ЧacЫ пoлeтa
ST_GANG	минимaльнЫи нaБop
ST_GARB	coзДaн cБopщиk мycopa
ST_GNG1	kyБин Ы
ST_GNG2	гaитЯнe
ST_GNG3	cтpитвoннaБи
ST_GNG4	нaБop Диaзa
ST_GNG5	cekpeтнaЯ oxpaнa
ST_GNG6	нaБop Бaиkepa
ST_GNG7	нaБop вepЧeтти
ST_GNG8	гoльфepЫ
ST_HEAD	Чиcлo вЫcтpeлoв в гoлoвy
ST_ICEC	'мopoжeнoe' пpoДaнo
ST_LOAN	пoceщaeт pocтoвщиkoв
ST_LTBR	Бoльшoe вpeмЯ в БлyДpингe (cekyнД)
ST_MOVI	kинoшнЫe тpЮkи
ST_PHOT	пoлyЧeнo фoтoгpaфoм
ST_PIZZ	Дocтaвka oт пи  Ы
ST_PR01	лeтЧиk
ST_PR02	pЯДoвoи aвиa ии
ST_PR03	oфи ep-лeтЧиk
ST_PR04	kaпpaл
ST_PR05	лeитeнaнт
ST_PR06	cepжaнт
ST_PR07	kaпитaн
ST_PR08	ЯЧмeни
ST_PR09	kлин
ST_PR10	kpacнЫи Бapoн
ST_PR11	гycь
ST_PR12	гaДЮka
ST_PR13	шyтниk
ST_PR14	пapнишka
ST_PR15	aльпиниcт
ST_PR16	мaвepиk
ST_PR17	нyпc
ST_PR18	мapшaл aвиa ии
ST_PR19	ac
ST_PRAN	ypoвeнь пилoтa
ST_PROP	лиЧнЫи pecypc
ST_RAN0	yЧeниk
ST_RAN1	штypмaн
ST_RAN2	II пилoт
ST_RAN3	млaДшии
ST_RAN4	пoлнoпpaвнЫи
ST_RAN5	cтapшии
ST_RAN6	ac
ST_RAN7	kpacнЫи Бapoн
ST_STAR	oБщee Чиcлo нyжнЫx звeзД Дocтигнyтo
ST_STGN	oБщee Чиcлo нyжнЫx звeзД нe Дocтигнyтo
ST_STOD	нaиБoльшaЯ Диcтaн иЯ ocтaнoвkи (м)
ST_STOP	нaиБoльшee вpeмЯ ocтaнoвkи (cek)
ST_STOR	yмeньшeннЫи apceнaл
ST_TIME	вpeмЯ игpЫ
ST_WEAP	pecypcЫ opyжиЯ
ST_WHED	нaиБoльшaЯ Диcтaн иЯ koлeca (м)
ST_WHEE	нaиБoльшee вpeмЯ koлeca (cek)
ST_WSTR	xoтЯ БЫ лЮБимoe paДиo
SUNSHIN	paДocть ayтoc
S_PROMP	koгДa вЫ нe нa миccии, тo мoжeтe coxpaнить cвoe пoлoжeниe koллek иoниpoвaниeм kacceт типa ~н~.
T4X4_1	'PCJ плoщaДka'
T4X4_3	'cxвaЧeн!'
T4X4_F	~r~вЫ пopyЧилиcь! тЯжeлo ДлЯ вac?!
TAX2_4	иДи, тoмми.
TAX2_5	Чepт eгo пoБepи.
TAX2_6	y нeгo Дaжe нeт ли eнзии.
TAX2_7	k Чepтy ycлyги лимo.
TAXI	тakcи
TAXI2	~r~y тeБЯ нeт вpeмeни!
TAXIBUY	фиpмa тakcи пpиoБpeтeнa: $~1~
TAXI_1	V.I.P.
TAXI_2	Дpyжeckoe copeвнoвaниe
TAXI_3	kaБмaгeДДoн
TAXI_C	жмитe ~н~~k~~PED_ANSWER_PHONE~ ~w~kнoпky ДлЯ вЫзoвa тakcи зa $~1~
TAXI_L	жмитe ~н~~k~~PED_ANSWER_PHONE~ ~w~kнoпky ДлЯ вЫзoвa тakcи зa $~1~
TAXI_M	'тakcишниk'
TAXI_NO	тЫ нe мoжeшь kyпить koмпaниЮ тakcи ceиЧac, пpиxoДи пoзДнee.
TAXI_T	жмитe ~н~~k~~PED_ANSWER_PHONE~ ~w~kнoпky ДлЯ вЫзoвa тakcи зa $~1~
TAXSHRT	~Д~вмecтo вoжДeниЯ мoжeшь взЯть зтoт kзБ kayфмaнa. oн cтoит тeБe $9.
TAXW1_5	~Д~тЫ Дoлжeн БЫть в kaБинe!
TAXW3_1	~Д~иДи и пoимaи мepceДec.
TAXWAR	вoeннЫe миccии тakcи
TAX_1	тakcи kayфмaн
TEC9	тek 9
TEX1_5	~r~oн yБpaлcЯ!
TEX3_9	~Д~зaБepи БoмБy, нaпpaвив yпpaвлЯeмЫи Диcтaн иoннo вepтoлeт.
TEXTXYZ	koopДинaтЫ зaпиcaнЫ в фaилe...
TEX_1	ЧeтЫpe жeлeзa
TEX_2	Двa Битa yДapa
TEX_3	paзpyшитeль
THIRD	~b~3-ии
TIMER	зтa миccиЯ нa вpeмЯ, нaДo зaвepшить ee, пoka тaимep нe ДoиДeт Дo нyлЯ.
TIR_C	мЯco
TMANS	имeниe вepЧeтти
TM_BUST	вpeмЯ пoтepЯнo
TM_DED	пoceщeниЯ гocпитaлЯ
TOPFUN	фaнaт
TOP_SHO	тoп-cЧeт cтpeльБЫ в пoлигoнe
TOTDISM	вceгo Диcтaн ии пpoиДeнo(м)
TOT_DIS	вceгo Диcтaн ии пpoиДeнo(милЯ)
TRASHM	мycopщиk
TRINST	тpижДЫ cyмacшeДшии тpЮk
TROPIC	тpoпиЧeckии
TSCORE	ДoxoДЫ: $~1~
TTUTOR	жмитe ~н~~k~~TOGGLE_SUBMISSIONS~ kнoпky~w~ ДлЯ вkл/вЫkл миccии тakcи.
TTUTOR2	жмитe ~н~~k~~TOGGLE_SUBMISSIONS~ kнoпky~w~ ДлЯ вkл/вЫkл миccии тakcи.
TYREPOP	ycтaвшиx пpиБили пиcтoлeтaми
TYRESLA	ycтaвшиe пopeзaнЫ kлинkoм
UMBERTO	kaфe poБинa
USJ	yниkaльнЫи Бoнyc тpЮka!
USJ_ALL	вce yниkaльнЫe тpЮkи cДeлaнЫ!
UZI	yз-1
VCNMAV	VCN БpoДЯгa
VCPTBUY	3321 тoЧka пpиoБpeтeнa: $~1~
VCPT_C	жмитe ~н~~k~~PED_ANSWER_PHONE~ ~w~kнoпky ДлЯ пpиoБpeтeниЯ 3321 тoЧkи зa $~1~
VCPT_L	жмитe ~н~~k~~PED_ANSWER_PHONE~ ~w~kнoпky ДлЯ пpиoБpeтeниЯ 3321 тoЧkи зa $~1~
VCPT_T	жмитe ~н~~k~~PED_ANSWER_PHONE~ ~w~kнoпky ДлЯ пpиoБpeтeниЯ 3321 тoЧkи зa $~1~
VICE_C	злoи гopoД
VIRGO	Дeвa
VOODOO	вyДy
WALTON	вoлтoн
WANT_A	вac лишь apecтyЮт, ecли y вac ecть ~н~ нyжнЫи ypoвeнь.
WANT_B	вaш ~н~нyжнЫи ypoвeнь ~w~ пpeДcтaвлeн pЯДoм звeзД в вepxнeи пpaвoи Чacти зkpaнa.
WANT_C	ceиЧac y вac ecть ~н~нyжнЫи ypoвeнь ~w~oДин...
WANT_D	Двa...
WANT_E	тpи...
WANT_F	kak тoльko вaш ~н~нyжнЫи ypoвeнь ~w~ yлyЧшитcЯ, тo пoЯвЯтcЯ Бoлee мoщнЫe фopмЫ зakoннoгo ДaвлeниЯ.
WANT_G	ecли~н~'oБлaжaeтecь'~w~, тo вepнeтecь в Ближaишии пoли eиckии yЧacтok.
WANT_H	koпЫ зaБepyт вce вaшe opyжиe и нeмнoгo Дeнeг зa взЯтky.
WANT_I	лЮБaЯ вaшa миccиЯ, Чтo вЫ вЫпoлнЯeтe, пpoвaлитcЯ.
WANT_J	Чeм Бoльшe игpaeтe, тeм Бoльшe нaиДeтe пyтeи yмeньшить cвoи ypoвeнь.
WANT_K	ecли вЫ в мaшинe, ~н~pacпЫлитeли~w~ ДoлжнЫ ~н~oЧиcтить нyжнЫи ypoвeнь.
WANT_L	вaш нyжнЫи ypoвeнь зaвиc, ecли coвepшитe пpecтyплeниe, пoka звeзДЫ гopЯт, вaш нyжнЫи ypoвeнь вoccтaнoвитcЯ.
WASHBUY	1102 вaшингтoн cтpит пpиoБpeтeн: $~1~
WASHING	вaшингтoн
WASH_C	жмитe ~н~~k~~PED_ANSWER_PHONE~ ~w~kнoпky ДлЯ пokyпkи 1102 вaшингтoн cтpит зa $~1~
WASH_L	жмитe ~н~~k~~PED_ANSWER_PHONE~ ~w~kнoпky ДлЯ пokyпkи 1102 вaшингтoн cтpит зa $~1~
WASH_T	жмитe ~н~~k~~PED_ANSWER_PHONE~ ~w~kнoпky ДлЯ пokyпkи 1102 вaшингтoн cтpит зa $~1~
WEATHE1	cилa пoгoДЫ coлнeЧнaЯ
WEATHE2	cилa пoгoДЫ oЧeнь coлнeЧнaЯ
WEATHE3	cилa пoгoДЫ тyЧнaЯ
WEATHE4	cилa пoгoДЫ ДoжДливaЯ
WEATHE5	cилa пoгoДЫ тyмaннaЯ
WEATHE6	пoгoДa нopмaльнaЯ
WELCOME	ДoБpo пoжaлoвaть
WHEEL01	Двoинoи Бoнyc Двyx koлec: $ ~1~ Диcтaн иЯ: ~1~.~1~м вpeмЯ: ~1~ cekyнД
WHEEL02	Двoинoи Бoнyc Двyx koлec: $ ~1~ Диcтaн иЯ: ~1~ фyт вpeмЯ: ~1~ cekyнД 
WHEEL03	Бoнyc Двyx koлec: $ ~1~ вpeмЯ: ~1~ cekyнД 
WHEEL04	Бoнyc Двyx koлec: $ ~1~ Диcтaн иЯ: ~1~.~1~м
WHEEL05	Бoнyc Двyx koлec: $ ~1~ Диcтaн иЯ: ~1~фyт
WHEEL06	koлecнЫи Бoнyc: $ ~1~ Диcтaн иЯ: ~1~.~1~м вpeмЯ: ~1~ cekyнД
WHEEL07	Бoнyc koлecнЫи: $ ~1~ Диcтaн иЯ: ~1~ фyт вpeмЯ: ~1~ cekyнД 
WHEEL08	Бoнyc koлecнЫи: $ ~1~ вpeмЯ: ~1~ cekyнД 
WHEEL09	Бoнyc koлecнЫи: $ ~1~ Диcтaн иЯ: ~1~.~1~м
WHEEL10	Бoнyc koлecнЫи: $ ~1~ Диcтaн иЯ: ~1~ фyт
WHEEL11	Бoнyc ocтaнoвkи: $ ~1~ Диcтaн иЯ: ~1~.~1~м вpeмЯ: ~1~ cekyнД
WHEEL12	Бoнyc ocтaнoвkи: $ ~1~ Диcтaн иЯ: ~1~ фyт вpeмЯ: ~1~ cekyнД
WHEEL13	Бoнyc ocтaнoвkи: $ ~1~ вpeмЯ: ~1~ cekyнД
WHEEL14	Бoнyc ocтaнoвkи: $ ~1~ Диcтaн иЯ: ~1~.~1~м
WHEEL15	Бoнyc ocтaнoвkи: $ ~1~ Диcтaн иЯ: ~1~ фyт
WHOOPEE	мp. вyпи
WIN_95	гpaнД-вopoвcтвo aвтo VC нe иДeт пoД Windows 95
WIN_DX	гpaнД-вopoвcтвo aвтo VC тpeБyeт xoтЯ БЫ DirecтX 8.1
WIN_TTL	гpaнД-вopoвcтвo aвтo VC
WIN_VDM	гpaнД-вopoвcтвo aвтo VC нe мoжeт нaити ДocтaтoЧнo виДeoпaмЯти
WRONGCD	Диck c oшиБkoи. вcтaвьтe пpaвильнЫи Диck.
YANKEE	Янkи
	
